Date,Kind,Model,Max Mode,Input (w/ Cache Write),Input (w/o Cache Write),Cache Read,Output Tokens,Total Tokens,Cost
"2025-10-29T14:46:13.662Z","Included","auto","No","453003","2922","3220921","27933","3704779","1.54"
"2025-10-29T14:37:19.883Z","Included","auto","No","169595","1984","1477919","7651","1657149","0.63"
"2025-10-29T14:12:08.394Z","Included","auto","No","127261","1836","647056","3473","779626","0.34"
"2025-10-29T14:02:36.045Z","Included","auto","No","113499","1752","588253","3990","707494","0.32"
"2025-10-29T14:02:15.872Z","Included","auto","No","0","1146","1319","21","2486","0.002"
"2025-10-29T13:55:23.054Z","Included","auto","No","102760","1653","613396","2027","719836","0.30"
"2025-10-29T13:46:20.728Z","Included","auto","No","85053","2033","918689","7032","1012807","0.38"
"2025-10-29T13:37:08.357Z","Included","auto","No","32764","2002","526455","6797","568018","0.22"
"2025-10-29T08:07:31.662Z","Included","auto","No","160000","1637","2128022","2657","2292316","0.75"
"2025-10-29T08:02:57.718Z","Included","auto","No","0","6065","636683","782","643530","0.17"
"2025-10-29T07:58:40.016Z","Included","auto","No","0","148869","13584","231","162684","0.19"
"2025-10-29T07:52:12.614Z","Included","auto","No","158255","1027","1092115","870","1252267","0.48"
"2025-10-29T07:51:12.324Z","Included","auto","No","0","1013","1297","20","2330","0.002"
"2025-10-29T07:43:07.280Z","Included","auto","No","96716","1530","2406372","4019","2508637","0.75"
"2025-10-29T07:36:44.850Z","Included","auto","No","84155","1908","1944615","2796","2033474","0.61"
"2025-10-29T07:31:57.386Z","Included","auto","No","51556","1024","127287","749","180616","0.10"
"2025-10-29T07:18:26.194Z","Included","auto","No","0","107217","1562868","7398","1677483","0.57"
"2025-10-29T07:14:38.960Z","Included","auto","No","0","32666","7946","1864","42476","0.05"
"2025-10-29T07:11:10.631Z","Included","auto","No","0","37758","468059","1521","507338","0.17"
"2025-10-29T07:03:10.838Z","Included","auto","No","30888","1709","220930","6129","259656","0.13"
"2025-10-29T06:52:32.171Z","Included","auto","No","0","18657","38014","2561","59232","0.05"
"2025-10-29T06:43:56.345Z","Included","auto","No","0","6539","5342","235","12116","0.01"
"2025-10-29T06:42:27.357Z","Included","auto","No","0","26352","11132","615","38099","0.04"
"2025-10-28T18:57:41.979Z","Included","auto","No","75761","46638","607894","4350","734643","0.33"
"2025-10-28T18:52:28.984Z","Included","auto","No","70076","39605","935375","7512","1052568","0.42"
"2025-10-28T18:45:43.323Z","Included","auto","No","57211","32469","713753","7078","810511","0.33"
"2025-10-28T18:18:08.425Z","Included","auto","No","31917","17596","860157","9574","919244","0.33"
"2025-10-28T18:14:24.974Z","Included","auto","No","24342","10038","165946","4199","204525","0.11"
"2025-10-28T18:00:32.241Z","Included","auto","No","21418","2690","86758","2547","113413","0.07"
"2025-10-27T13:51:49.972Z","Included","auto","No","203","854","89174","131","90362","0.02"
"2025-10-27T13:47:40.311Z","Included","auto","No","12620","1317","1210451","2117","1226505","0.33"
"2025-10-27T13:43:07.930Z","Included","auto","No","3329","2012","218406","1338","225085","0.07"
"2025-10-27T13:36:45.995Z","Included","auto","No","10748","1323","598840","2326","613237","0.18"
"2025-10-27T13:30:14.328Z","Included","auto","No","5103","1417","405899","1567","413986","0.12"
"2025-10-27T13:21:47.210Z","Included","auto","No","15685","1714","857349","5919","880667","0.27"
"2025-10-27T13:17:52.887Z","Included","auto","No","35998","1530","220035","696","258259","0.11"
"2025-10-27T12:51:49.162Z","Included","auto","No","13997","1676","693929","3944","713546","0.22"
"2025-10-27T12:44:06.451Z","Included","auto","No","31483","1964","874806","5445","913698","0.29"
"2025-10-27T12:38:11.349Z","Included","auto","No","23048","1906","421513","4182","450649","0.16"
"2025-10-27T08:05:03.894Z","Included","auto","No","14717","3167","812099","7294","837277","0.27"
"2025-10-27T08:04:25.271Z","Included","auto","No","0","608","1274","19","1901","0.001"
"2025-10-27T07:58:11.160Z","Included","auto","No","16971","2995","599673","4325","623964","0.20"
"2025-10-27T07:53:59.744Z","Included","auto","No","118254","1955","348296","3818","472323","0.26"
"2025-10-27T07:44:03.052Z","Included","auto","No","98802","2114","453227","2506","556649","0.25"
"2025-10-27T07:40:04.319Z","Included","auto","No","94598","2521","642023","3758","742900","0.30"
"2025-10-27T07:35:18.623Z","Included","auto","No","88505","3247","681339","8857","781948","0.34"
"2025-10-27T07:23:36.107Z","Included","auto","No","91814","3355","1009098","9139","1113406","0.43"
"2025-10-27T06:56:13.239Z","Included","auto","No","62391","1485","161099","1153","226128","0.13"
"2025-10-27T06:49:19.415Z","Included","auto","No","72348","4973","662668","7778","747767","0.31"
"2025-10-27T05:52:44.684Z","Included","auto","No","90917","2598","272037","34469","400021","0.39"
"2025-10-27T05:50:12.137Z","Included","auto","No","18431","1765","15968","2288","38452","0.04"
"2025-10-26T14:39:11.720Z","Included","auto","No","3898","1286","162987","1075","169246","0.05"
"2025-10-26T14:34:04.459Z","Included","auto","No","4038","1277","146855","1160","153330","0.05"
"2025-10-26T14:22:42.072Z","Included","auto","No","18042","1192","101256","1150","121640","0.06"
"2025-10-26T14:20:22.431Z","Included","auto","No","16300","1022","21274","787","39383","0.03"
"2025-10-26T14:13:54.494Z","Included","auto","No","4682","1488","227803","1955","235928","0.08"
"2025-10-26T14:07:12.494Z","Included","auto","No","7250","1171","358709","2027","369157","0.11"
"2025-10-26T14:02:20.521Z","Included","auto","No","11493","1458","394972","2162","410085","0.13"
"2025-10-26T14:00:03.753Z","Included","auto","No","498","1015","76590","473","78576","0.02"
"2025-10-26T13:55:14.392Z","Included","auto","No","24679","1100","163883","2515","192177","0.09"
"2025-10-26T13:54:11.364Z","Included","auto","No","0","1100","1323","21","2444","0.002"
"2025-10-26T13:52:03.494Z","Included","auto","No","0","1108","1326","21","2455","0.002"
"2025-10-25T15:57:40.959Z","Included","auto","No","14447","2499","620227","5140","642313","0.21"
"2025-10-25T15:51:37.367Z","Included","auto","No","25755","1939","441858","4361","473913","0.17"
"2025-10-25T15:28:15.981Z","Included","auto","No","29967","3151","981879","11181","1026178","0.35"
"2025-10-25T15:07:57.886Z","Included","auto","No","21094","2530","1209394","7091","1240109","0.37"
"2025-10-25T15:05:21.131Z","Included","auto","No","2575","1339","124743","1121","129778","0.04"
"2025-10-25T15:03:10.552Z","Included","auto","No","16013","980","374412","2911","394316","0.13"
"2025-10-25T14:55:05.914Z","Included","auto","No","4203","1562","320102","1867","327734","0.10"
"2025-10-25T14:50:42.212Z","Included","auto","No","9047","3399","120152","1148","133746","0.05"
"2025-10-25T14:46:23.036Z","Included","auto","No","21004","2876","459405","3434","486719","0.17"
"2025-10-25T13:57:35.478Z","Included","auto","No","50601","982","1318335","6523","1376441","0.43"
"2025-10-25T08:26:47.013Z","Included","auto","No","55474","3469","167820","2427","229190","0.13"
"2025-10-25T08:20:05.830Z","Included","auto","No","27357","2584","197145","4656","231742","0.11"
"2025-10-25T06:23:51.947Z","Included","auto","No","1287","1163","38697","780","41927","0.02"
"2025-10-25T06:22:44.999Z","Included","auto","No","2573","1075","17545","786","21979","0.01"
"2025-10-25T06:17:58.505Z","Included","auto","No","15662","1308","1949","1431","20350","0.03"
"2025-10-25T06:01:41.713Z","Included","auto","No","38241","4215","1959","5146","49561","0.08"
"2025-10-25T05:51:07.598Z","Included","auto","No","34654","10876","71346","15153","132029","0.17"
"2025-10-25T05:03:47.763Z","Included","auto","No","48122","1453","643819","4658","698052","0.25"
"2025-10-25T05:01:38.915Z","Included","auto","No","7939","1652","454228","3230","467049","0.14"
"2025-10-25T05:00:26.153Z","Included","auto","No","47631","1057","140620","1459","190767","0.10"
"2025-10-25T04:22:00.493Z","Included","auto","No","96132","2548","1202675","10766","1312121","0.49"
"2025-10-25T04:00:31.285Z","Included","auto","No","9784","950","53372","1635","65741","0.04"
"2025-10-25T04:00:28.370Z","Aborted, Not Charged","auto","No","0","339","0","3","342","0.000"
"2025-10-24T17:55:55.265Z","Included","auto","No","13522","944","124918","1353","140737","0.06"
"2025-10-24T17:50:45.457Z","Included","auto","No","45591","1450","321783","5843","374667","0.17"
"2025-10-24T17:42:13.932Z","Included","auto","No","35989","175328","589411","4843","805571","0.44"
"2025-10-24T17:38:22.484Z","Included","auto","No","6126","170016","1057918","3841","1237901","0.51"
"2025-10-24T17:35:50.296Z","Included","auto","No","14811","169619","335803","582","520815","0.32"
"2025-10-24T17:30:16.752Z","Included","auto","No","28662","160253","4386213","2622","4577750","1.35"
"2025-10-24T17:22:01.421Z","Included","auto","No","32585","156508","2239005","1386","2429484","0.80"
"2025-10-24T17:02:22.344Z","Included","auto","No","16235","151460","2500629","1665","2669989","0.84"
"2025-10-24T16:55:45.379Z","Included","auto","No","15906","144132","1785974","1371","1947383","0.65"
"2025-10-24T16:48:38.748Z","Included","auto","No","9702","141063","2458976","1710","2611451","0.81"
"2025-10-24T16:46:05.399Z","Included","auto","No","131971","8593","1278645","1089","1420298","0.50"
"2025-10-24T16:42:48.798Z","Included","auto","No","8772","137029","2551312","2293","2699406","0.83"
"2025-10-24T16:42:34.794Z","Included","auto","No","9525","135584","132132","200","277441","0.22"
"2025-10-24T16:38:42.320Z","Included","auto","No","28860","132767","1212536","1096","1375259","0.51"
"2025-10-24T16:29:53.072Z","Included","auto","No","33360","1086","493925","548","528919","0.17"
"2025-10-24T16:23:16.850Z","Included","auto","No","7443","112041","719620","769","839873","0.33"
"2025-10-24T16:19:40.238Z","Included","auto","No","111177","110528","128158","183","350046","0.31"
"2025-10-24T16:13:03.070Z","Included","auto","No","2871","112023","114110","126","229130","0.17"
"2025-10-24T16:09:32.919Z","Included","auto","No","39166","108648","418501","478","566793","0.29"
"2025-10-24T16:00:01.814Z","Included","auto","No","12875","82956","430023","607","526461","0.23"
"2025-10-24T15:51:58.855Z","Included","auto","No","15838","74423","1073688","1268","1165217","0.39"
"2025-10-24T15:46:05.188Z","Included","auto","No","31849","66481","1125488","2403","1226221","0.42"
"2025-10-24T15:39:24.849Z","Included","auto","No","21702","47516","275403","780","345401","0.16"
"2025-10-24T15:33:06.844Z","Included","auto","No","15544","44807","627045","964","688360","0.24"
"2025-10-24T15:25:32.577Z","Included","auto","No","20964","31570","1246454","2149","1301137","0.39"
"2025-10-24T15:20:32.935Z","Included","auto","No","13911","24287","844578","1764","884540","0.27"
"2025-10-24T15:16:43.896Z","Included","auto","No","13321","16967","349226","1169","380683","0.13"
"2025-10-24T15:13:00.732Z","Included","auto","No","18791","12082","321207","3103","355183","0.14"
"2025-10-24T15:11:43.732Z","Included","auto","No","629","12252","70980","1529","85390","0.04"
"2025-10-24T15:08:19.265Z","Included","auto","No","959","9514","23644","25","34142","0.02"
"2025-10-24T15:05:46.036Z","Included","auto","No","22456","1307","1945","732","26440","0.03"
"2025-10-24T14:13:39.303Z","Included","auto","No","5687","157450","459325","3749","626211","0.34"
"2025-10-24T14:09:03.171Z","Included","auto","No","9142","156723","143545","493","309903","0.25"
"2025-10-24T13:59:38.955Z","Included","auto","No","26800","4687","1070970","1116","1103573","0.31"
"2025-10-24T13:58:52.473Z","Included","auto","No","1606","134031","261107","515","397259","0.24"
"2025-10-24T13:55:36.545Z","Included","auto","No","7991","129932","505664","994","644581","0.30"
"2025-10-24T13:51:27.383Z","Included","auto","No","30502","106628","1086796","2598","1226524","0.46"
"2025-10-24T13:45:55.163Z","Included","auto","No","95839","87778","98082","421","282120","0.26"
"2025-10-24T13:28:54.398Z","Included","auto","No","68532","174723","438167","897","682319","0.42"
"2025-10-24T13:26:09.750Z","Errored, Not Charged","auto","No","24883","849","1481780","1427","1508939","0.41"
"2025-10-24T13:20:33.133Z","Included","auto","No","2676","146276","619213","533","768698","0.34"
"2025-10-24T13:18:26.728Z","Errored, Not Charged","auto","No","5004","1207","1063847","892","1070950","0.28"
"2025-10-24T13:14:14.583Z","Included","auto","No","10742","136035","1745775","2537","1895089","0.64"
"2025-10-24T13:06:31.305Z","Included","auto","No","30401","111311","1350647","2988","1495347","0.53"
"2025-10-24T13:03:34.182Z","Included","auto","No","18115","109605","221289","760","349769","0.22"
"2025-10-24T12:58:14.107Z","Included","auto","No","9158","90923","1014886","2897","1117864","0.40"
"2025-10-24T12:51:57.058Z","Included","auto","No","4316","87999","970719","2304","1065338","0.37"
"2025-10-24T12:51:44.078Z","Errored, Not Charged","auto","No","0","0","0","0","0","0.00"
"2025-10-24T12:44:27.365Z","Included","auto","No","24144","65809","1471601","2875","1564429","0.50"
"2025-10-24T12:42:22.073Z","Included","auto","No","17637","55258","265931","580","339406","0.16"
"2025-10-24T12:39:54.528Z","Included","auto","No","2658","54882","127658","579","185777","0.11"
"2025-10-24T12:34:54.163Z","Included","auto","No","6076","50158","602408","1949","660591","0.23"
"2025-10-24T12:33:49.269Z","Included","auto","No","4706","45999","52626","456","103787","0.08"
"2025-10-24T12:28:04.164Z","Included","auto","No","16544","41897","510685","1382","570508","0.21"
"2025-10-24T12:18:59.662Z","Included","auto","No","42177","2183","577826","7996","630182","0.25"
"2025-10-24T06:56:41.558Z","Included","auto","No","3584","4157","82990","1335","92066","0.04"
"2025-10-24T06:50:26.407Z","Included","auto","No","4605","36251","438633","2263","481752","0.17"
"2025-10-24T06:47:56.224Z","Included","auto","No","5060","34491","561330","2423","603304","0.20"
"2025-10-24T06:45:23.253Z","Included","auto","No","14461","31281","186424","584","232750","0.11"
"2025-10-24T06:38:27.028Z","Included","auto","No","3686","28386","313641","708","346421","0.12"
"2025-10-24T06:36:42.854Z","Included","auto","No","2088","27450","185891","366","215795","0.09"
"2025-10-24T06:34:50.676Z","Included","auto","No","8229","26643","238926","283","274081","0.11"
"2025-10-24T06:33:33.282Z","Included","auto","No","2061","26282","121270","196","149809","0.07"
"2025-10-24T06:32:28.748Z","Included","auto","No","19280","25726","102964","188","148158","0.08"
"2025-10-24T06:21:49.645Z","Included","auto","No","56502","22501","408207","1247","488457","0.21"
"2025-10-24T05:58:51.211Z","Included","auto","No","4737","1093","28874","680","35384","0.02"
"2025-10-24T05:46:07.877Z","Included","auto","No","8333","22250","150379","2805","183767","0.09"
"2025-10-24T05:37:09.389Z","Included","auto","No","5008","20493","96306","1618","123425","0.07"
"2025-10-24T05:29:19.180Z","Included","auto","No","13244","19927","83166","2796","119133","0.08"
"2025-10-24T05:13:23.949Z","Included","auto","No","37934","16156","227444","2154","283688","0.14"
"2025-10-24T04:35:47.776Z","Included","auto","No","8088","15264","234844","1417","259613","0.10"
"2025-10-24T04:30:19.164Z","Included","auto","No","29212","12047","224232","4492","269983","0.13"
"2025-10-23T22:09:33.074Z","Included","auto","No","31188","44125","414336","21437","511086","0.33"
"2025-10-23T22:05:33.351Z","Included","auto","No","8157","8869","76765","8062","101853","0.09"
"2025-10-23T21:56:09.204Z","Included","auto","No","21470","32182","697664","14450","765766","0.33"
"2025-10-23T21:51:56.823Z","Included","auto","No","84869","2433","11266","1810","100378","0.12"
"2025-10-23T21:45:54.923Z","Included","auto","No","61615","1862","588918","2468","654863","0.24"
"2025-10-23T21:30:06.790Z","Included","auto","No","17039","23517","2117468","6040","2164064","0.62"
"2025-10-23T21:26:37.153Z","Included","auto","No","160608","3843","179525","926","344902","0.26"
"2025-10-23T21:19:47.314Z","Included","auto","No","0","882","1258","19","2159","0.002"
"2025-10-23T21:16:58.185Z","Included","auto","No","4062","2759","162231","1141","170193","0.06"
"2025-10-23T21:13:46.270Z","Included","auto","No","4341","4789","319782","1338","330250","0.10"
"2025-10-23T21:10:45.571Z","Included","auto","No","5065","3567","472521","1783","482936","0.14"
"2025-10-23T21:05:48.806Z","Included","auto","No","147555","3725","321621","1458","474359","0.28"
"2025-10-23T20:34:54.270Z","Included","auto","No","2690","4196","454306","1240","462432","0.13"
"2025-10-23T20:31:37.575Z","Included","auto","No","139887","2737","11554","1108","155286","0.19"
"2025-10-23T20:18:11.482Z","Included","auto","No","139080","17005","2101901","7464","2265450","0.77"
"2025-10-23T20:13:58.781Z","Included","auto","No","121720","8478","777387","3077","910662","0.38"
"2025-10-23T20:09:32.571Z","Included","auto","No","115670","7479","867907","3647","994703","0.39"
"2025-10-23T20:02:12.155Z","Included","auto","No","79400","2397","2164639","3740","2250176","0.67"
"2025-10-23T19:58:15.420Z","Included","auto","No","89689","5088","110050","775","205602","0.15"
"2025-10-23T19:54:07.360Z","Included","auto","No","87962","7571","484345","3118","582996","0.26"
"2025-10-23T19:44:12.614Z","Included","auto","No","12172","14021","943655","5555","975403","0.30"
"2025-10-23T19:42:03.126Z","Included","auto","No","8976","3627","152633","1388","166624","0.06"
"2025-10-23T19:38:13.276Z","Included","auto","No","5151","7776","216800","2329","232056","0.08"
"2025-10-23T19:35:54.078Z","Included","auto","No","4364","2175","67744","1068","75351","0.03"
"2025-10-23T19:33:32.806Z","Included","auto","No","59116","7547","349699","2760","419122","0.19"
"2025-10-23T19:25:33.012Z","Included","auto","No","9224","3648","247495","2347","262714","0.09"
"2025-10-23T19:22:00.807Z","Included","auto","No","10693","9051","339179","3094","362017","0.13"
"2025-10-23T19:17:20.455Z","Included","auto","No","45149","4599","114157","2569","166474","0.11"
"2025-10-23T19:09:27.411Z","Included","auto","No","40853","11594","380695","3212","436354","0.18"
"2025-10-23T19:04:41.557Z","Included","auto","No","4080","4163","81672","2593","92508","0.05"
"2025-10-23T18:54:31.693Z","Included","auto","No","26216","18143","189749","2677","236785","0.12"
"2025-10-23T18:47:34.343Z","Included","auto","No","20570","23242","629960","9995","683767","0.27"
"2025-10-23T18:45:12.298Z","Included","auto","No","1897","3056","33024","1738","39715","0.02"
"2025-10-23T18:42:43.683Z","Included","auto","No","4209","1579","28648","1338","35774","0.02"
"2025-10-23T18:40:45.635Z","Included","auto","No","2934","3378","23538","2287","32137","0.03"
"2025-10-23T18:37:32.736Z","Included","auto","No","2317","2646","43773","1879","50615","0.03"
"2025-10-23T17:41:37.743Z","Included","auto","No","923","1065","33344","125","35457","0.01"
"2025-10-23T17:39:28.501Z","Included","auto","No","5301","7229","351600","2121","366251","0.12"
"2025-10-23T17:35:29.135Z","Included","auto","No","9448","1363","184670","1052","196533","0.07"
"2025-10-23T17:34:14.924Z","Included","auto","No","1357","1003","64229","393","66982","0.02"
"2025-10-23T17:33:23.872Z","Included","auto","No","7863","1028","50423","376","59690","0.03"
"2025-10-23T17:27:05.967Z","Included","auto","No","3749","1555","476913","1748","483965","0.14"
"2025-10-23T17:24:32.470Z","Included","auto","No","3010","1120","388119","1366","393615","0.11"
"2025-10-23T17:21:30.529Z","Included","auto","No","16565","3039","398020","5712","423336","0.16"
"2025-10-23T17:17:19.307Z","Included","auto","No","69849","9398","1472704","4598","1556549","0.49"
"2025-10-23T17:12:51.610Z","Included","auto","No","2938","787","288378","1336","293439","0.08"
"2025-10-23T17:11:11.944Z","Included","auto","No","3487","1449","343204","1676","349816","0.10"
"2025-10-23T17:07:45.382Z","Included","auto","No","28643","1073","804750","4444","838910","0.26"
"2025-10-23T16:55:51.042Z","Included","auto","No","14545","2220","689992","4516","711273","0.22"
"2025-10-23T16:51:45.335Z","Included","auto","No","48224","1853","326910","3341","380328","0.16"
"2025-10-23T16:43:00.420Z","Included","auto","No","66752","2499","860612","6310","936173","0.34"
"2025-10-23T16:30:46.997Z","Included","auto","No","7452","1835","1024746","3391","1037424","0.29"
"2025-10-23T16:24:29.715Z","Included","auto","No","5568","1920","643155","2888","653531","0.19"
"2025-10-23T16:20:29.086Z","Included","auto","No","101649","1448","4634","712","108443","0.13"
"2025-10-23T15:59:21.489Z","Included","auto","No","31677","936","970966","2940","1006519","0.30"
"2025-10-23T15:51:39.997Z","Included","auto","No","35121","2440","720616","2860","761037","0.24"
"2025-10-23T15:42:59.048Z","Included","auto","No","64358","1057","737710","24935","828060","0.42"
"2025-10-23T15:35:53.702Z","Included","auto","No","14234","2326","770133","6193","792886","0.25"
"2025-10-23T15:17:52.728Z","Included","auto","No","25978","2277","1190749","12756","1231760","0.41"
"2025-10-23T15:16:55.390Z","Included","auto","No","13363","1464","9232","470","24529","0.02"
"2025-10-23T15:12:24.694Z","Included","auto","No","2806","1513","9247","440","14006","0.01"
"2025-10-23T14:38:10.532Z","Included","auto","No","18321","1896","415125","2839","438181","0.15"
"2025-10-23T14:19:24.904Z","Included","auto","No","1900","1513","45095","1290","49798","0.02"
"2025-10-23T14:14:26.627Z","Included","auto","No","13915","1433","39518","1286","56152","0.04"
"2025-10-23T08:23:41.490Z","Included","auto","No","6255","4391","71267","2037","83950","0.04"
"2025-10-23T08:21:53.892Z","Included","auto","No","1049","4125","32395","1492","39061","0.02"
"2025-10-23T08:18:15.769Z","Included","auto","No","9966","18573","186116","1049","215704","0.09"
"2025-10-23T08:11:32.467Z","Included","auto","No","496","1342","14024","492","16354","0.01"
"2025-10-23T08:08:41.540Z","Included","auto","No","4959","894","139784","870","146507","0.05"
"2025-10-23T07:58:30.567Z","Included","auto","No","1766","1284","202322","770","206142","0.06"
"2025-10-23T07:52:47.675Z","Included","auto","No","13355","1931","464640","10068","489994","0.20"
"2025-10-23T07:49:23.499Z","Included","auto","No","2004","1209","108297","939","112449","0.04"
"2025-10-23T07:47:44.333Z","Included","auto","No","5494","1339","78961","795","86589","0.03"
"2025-10-23T07:36:44.944Z","Included","auto","No","59522","1699","902906","1828","965955","0.31"
"2025-10-23T07:32:17.502Z","Included","auto","No","88232","1762","1180904","4053","1274951","0.43"
"2025-10-23T07:30:50.542Z","Included","auto","No","934","803","56286","78","58101","0.02"
"2025-10-23T07:26:27.174Z","Included","auto","No","48286","1884","858128","6914","915212","0.32"
"2025-10-23T07:08:37.385Z","Included","auto","No","35771","762","120936","10889","168358","0.14"
"2025-10-23T06:38:34.741Z","Included","auto","No","0","824","1229","19","2072","0.001"
"2025-10-23T06:38:26.457Z","Included","auto","No","0","0","0","0","0","0.00"
"2025-10-23T06:36:09.201Z","Included","auto","No","0","802","1216","16","2034","0.001"
"2025-10-23T06:34:08.856Z","Included","auto","No","14844","972","8049","9102","32967","0.08"
"2025-10-22T11:14:05.794Z","Included","auto","No","832","1049","92228","638","94747","0.03"
"2025-10-22T11:12:16.684Z","Included","auto","No","14979","1022","124814","907","141722","0.06"
"2025-10-22T10:04:38.634Z","Included","auto","No","10017","1916","299678","3366","314977","0.11"
"2025-10-22T09:54:58.149Z","Included","auto","No","52193","3487","1013855","3019","1072554","0.34"
"2025-10-22T09:41:12.478Z","Included","auto","No","23398","2011","280758","1723","307890","0.11"
"2025-10-22T08:53:53.057Z","Included","auto","No","10768","1734","580560","5350","598412","0.19"
"2025-10-22T08:42:37.178Z","Included","auto","No","41450","1966","478256","6276","527948","0.21"
"2025-10-22T08:34:32.247Z","Included","auto","No","11725","2314","382774","3817","400630","0.14"
"2025-10-22T08:30:33.087Z","Included","auto","No","2434","1154","43027","539","47154","0.02"
"2025-10-22T08:22:31.538Z","Included","auto","No","8437","1668","597528","3106","610739","0.18"
"2025-10-22T08:20:26.572Z","Included","auto","No","8058","1964","252067","1911","264000","0.09"
"2025-10-22T08:12:37.781Z","Included","auto","No","14802","1702","183658","2504","202666","0.08"
"2025-10-22T07:10:44.339Z","Included","auto","No","813","1216","71029","660","73718","0.02"
"2025-10-22T07:07:13.711Z","Included","auto","No","27281","1327","42793","806","72207","0.05"
"2025-10-22T07:00:06.776Z","Included","auto","No","254","27641","67096","554","95545","0.05"
"2025-10-22T06:51:13.879Z","Included","auto","No","14981","31532","275260","1070","322843","0.13"
"2025-10-22T06:44:37.914Z","Included","auto","No","4016","13163","249355","1308","267842","0.09"
"2025-10-22T06:39:23.846Z","Included","auto","No","11509","824","157451","914","170698","0.06"
"2025-10-22T06:06:33.658Z","Included","auto","No","1673","11717","83424","763","97577","0.04"
"2025-10-22T06:05:12.729Z","Included","auto","No","996","10638","46836","452","58922","0.03"
"2025-10-22T06:01:18.514Z","Included","auto","No","7885","837","102391","1181","112294","0.04"
"2025-10-22T05:20:51.974Z","Included","auto","No","0","34435","456677","1133","492245","0.16"
"2025-10-22T05:12:14.184Z","Included","auto","No","0","21323","698579","1901","721803","0.21"
"2025-10-22T05:05:33.521Z","Included","auto","No","0","32168","807404","2421","841993","0.26"
"2025-10-22T04:55:36.087Z","Included","auto","No","0","32547","301731","1667","335945","0.13"
"2025-10-22T04:51:26.056Z","Included","auto","No","0","22957","310698","1591","335246","0.12"
"2025-10-22T04:45:41.219Z","Included","auto","No","0","11499","7985","152","19636","0.02"
"2025-10-22T04:25:17.641Z","Included","auto","No","0","16438","21093","158","37689","0.03"
"2025-10-22T04:22:13.234Z","Included","auto","No","0","111038","8018","150","119206","0.14"
"2025-10-22T03:45:50.405Z","Included","auto","No","0","39437","311195","413","351045","0.13"
"2025-10-22T03:35:01.748Z","Included","auto","No","0","122925","1751752","2659","1877336","0.61"
"2025-10-22T03:31:39.952Z","Included","auto","No","8345","6958","260947","3235","279485","0.10"
"2025-10-22T03:26:32.017Z","Included","auto","No","117931","8191","11207","1354","138683","0.17"
"2025-10-22T03:16:59.237Z","Included","auto","No","126260","2153","1341","2198","131952","0.17"
"2025-10-21T14:53:06.884Z","Included","auto","No","13668","2071","1142611","5594","1163944","0.34"
"2025-10-21T14:46:30.026Z","Included","auto","No","78469","1599","506008","1182","587258","0.23"
"2025-10-21T14:12:02.432Z","Included","auto","No","43828","864","1155844","2783","1203319","0.36"
"2025-10-21T14:04:11.746Z","Included","auto","No","40845","800","266930","4855","313430","0.15"
"2025-10-21T14:02:40.219Z","Included","auto","No","2323","5779","40899","1645","50646","0.03"
"2025-10-21T14:01:43.856Z","Errored, Not Charged","auto","No","29674","5013","54123","646","89456","0.06"
"2025-10-21T13:57:43.790Z","Included","auto","No","13478","69230","41623","2445","126776","0.13"
"2025-10-21T12:59:30.917Z","Included","auto","No","13380","3987","1249","581","19197","0.03"
"2025-10-21T12:56:44.580Z","Included","auto","No","3194","4587","11596","514","19891","0.02"
"2025-10-21T12:50:30.070Z","Included","auto","No","65469","70677","8793","1157","146096","0.18"
"2025-10-21T12:42:21.122Z","Included","auto","No","9521","61812","1150244","2199","1223776","0.39"
"2025-10-21T12:34:17.974Z","Included","auto","No","322475","211581","1015262","5991","1555309","0.96"
"2025-10-21T12:25:54.884Z","Included","auto","No","15836","99033","2664511","2683","2782063","0.83"
"2025-10-21T12:19:49.220Z","Included","auto","No","1940","97529","401039","537","501045","0.23"
"2025-10-21T12:14:01.417Z","Included","auto","No","17847","82982","2453112","4134","2558075","0.76"
"2025-10-21T12:05:37.098Z","Included","auto","No","74358","65020","1321866","1978","1463222","0.52"
"2025-10-21T11:59:30.042Z","Included","auto","No","3141","37064","256172","678","297055","0.12"
"2025-10-21T11:52:44.293Z","Included","auto","No","3206","33718","395781","982","433687","0.15"
"2025-10-21T11:50:06.802Z","Included","auto","No","2609","31423","293390","822","328244","0.12"
"2025-10-21T11:48:24.562Z","Included","auto","No","13068","17832","142461","505","173866","0.08"
"2025-10-21T11:45:22.714Z","Included","auto","No","3497","13116","165519","881","183013","0.07"
"2025-10-21T11:38:56.649Z","Included","auto","No","16293","110448","1601934","1663","1730338","0.57"
"2025-10-21T11:35:24.578Z","Included","auto","No","5456","105156","1194469","1282","1306363","0.44"
"2025-10-21T11:31:30.329Z","Included","auto","No","9092","97793","1536911","2022","1645818","0.53"
"2025-10-21T11:26:29.030Z","Included","auto","No","8260","90306","1115317","1759","1215642","0.41"
"2025-10-21T11:19:45.508Z","Included","auto","No","30047","83194","1252386","2283","1367910","0.47"
"2025-10-21T11:11:32.053Z","Included","auto","No","30096","50148","409481","1603","491328","0.21"
"2025-10-21T11:03:04.251Z","Included","auto","No","2045","23811","83032","907","109795","0.06"
"2025-10-21T11:01:40.486Z","Included","auto","No","25866","23727","2754","356","52703","0.06"
"2025-10-21T10:56:35.155Z","Included","auto","No","19361","34544","99217","1892","155014","0.10"
"2025-10-21T09:04:22.481Z","Included","auto","No","1322","838","11759","407","14326","0.01"
"2025-10-21T09:03:05.326Z","Included","auto","No","182","61726","83947","290","146145","0.10"
"2025-10-21T08:58:28.312Z","Included","auto","No","75035","58853","1212846","1634","1348368","0.48"
"2025-10-21T08:38:05.953Z","Included","auto","No","77385","50959","2603320","3431","2735095","0.83"
"2025-10-21T08:36:43.888Z","Included","auto","No","1532","49558","272134","678","323902","0.14"
"2025-10-21T08:20:45.033Z","Included","auto","No","59791","35383","2018850","2908","2116932","0.64"
"2025-10-21T08:02:45.475Z","Included","auto","No","5393","1769","129574","1387","138123","0.05"
"2025-10-21T07:57:18.968Z","Included","auto","No","45694","86359","9351","462","141866","0.17"
"2025-10-21T07:52:01.599Z","Included","auto","No","9134","81471","2081259","5699","2177563","0.67"
"2025-10-21T07:47:14.774Z","Included","auto","No","10228","77687","1306034","7367","1401316","0.48"
"2025-10-21T07:42:39.793Z","Included","auto","No","88741","63615","1270448","3180","1425984","0.53"
"2025-10-21T07:39:24.856Z","Included","auto","No","8629","56463","1378390","3293","1446775","0.45"
"2025-10-21T07:32:58.655Z","Included","auto","No","7728","51869","1448688","3608","1511893","0.46"
"2025-10-21T07:21:55.418Z","Included","auto","No","57509","48371","788232","6676","900788","0.37"
"2025-10-21T06:59:33.712Z","Included","auto","No","5242","43224","1134397","2017","1184880","0.36"
"2025-10-21T06:53:51.599Z","Included","auto","No","1906","41371","501816","1083","546176","0.19"
"2025-10-21T06:50:32.758Z","Included","auto","No","6198","36018","508058","1983","552257","0.19"
"2025-10-21T06:42:57.135Z","Included","auto","No","35815","34322","304390","909","375436","0.17"
"2025-10-21T06:33:47.736Z","Included","auto","No","4357","32483","239035","1406","277281","0.11"
"2025-10-21T06:30:19.438Z","Included","auto","No","2229","29059","108850","268","140406","0.07"
"2025-10-21T06:27:58.485Z","Included","auto","No","2268","25926","201427","874","230495","0.09"
"2025-10-21T06:25:42.554Z","Included","auto","No","25303","20952","216150","1538","263943","0.12"
"2025-10-21T06:03:43.201Z","Included","auto","No","1123","19617","79707","683","101130","0.05"
"2025-10-21T06:00:22.298Z","Included","auto","No","660","18656","76707","242","96265","0.04"
"2025-10-21T05:55:31.027Z","Included","auto","No","5296","15796","220659","2184","243935","0.09"
"2025-10-21T05:46:36.718Z","Included","auto","No","12244","2104","211036","2141","227525","0.08"
"2025-10-21T05:37:28.009Z","Included","auto","No","30762","32076","44821","2538","110197","0.10"
"2025-10-20T19:59:47.569Z","Included","auto","No","80035","113745","860725","3326","1057831","0.48"
"2025-10-20T19:55:26.063Z","Included","auto","No","64937","28915","1256786","2673","1353311","0.45"
"2025-10-20T19:45:14.780Z","Included","auto","No","38209","137433","391102","10226","576970","0.38"
"2025-10-20T19:40:08.448Z","Included","auto","No","152269","68861","1124072","7430","1352632","0.60"
"2025-10-20T19:35:41.179Z","Included","auto","No","4341","63562","701486","2345","771734","0.27"
"2025-10-20T19:32:57.084Z","Included","auto","No","4265","60756","480539","2298","547858","0.22"
"2025-10-20T19:30:35.941Z","Included","auto","No","5112","58398","364994","3105","431609","0.19"
"2025-10-20T19:27:46.235Z","Included","auto","No","7617","54664","426481","3649","492411","0.21"
"2025-10-20T19:23:53.584Z","Included","auto","No","3620","49909","478835","1628","533992","0.20"
"2025-10-20T19:17:29.628Z","Included","auto","No","6042","46820","297643","3938","354443","0.16"
"2025-10-20T19:14:13.552Z","Included","auto","No","68743","43662","279378","3520","395303","0.23"
"2025-10-20T19:09:52.780Z","Included","auto","No","9104","40790","312788","4791","367473","0.17"
"2025-10-20T19:05:50.110Z","Included","auto","No","7584","38958","293606","3170","343318","0.15"
"2025-10-20T19:02:41.088Z","Included","auto","No","4591","1477","272843","1212","280123","0.08"
"2025-10-20T18:59:36.759Z","Included","auto","No","44034","30657","203703","4162","282556","0.17"
"2025-10-20T18:38:33.192Z","Included","auto","No","15837","19433","766817","7748","809835","0.28"
"2025-10-20T18:33:05.095Z","Included","auto","No","44901","207195","938050","8385","1198531","0.60"
"2025-10-20T18:27:15.184Z","Included","auto","No","5881","93727","771650","3854","875112","0.34"
"2025-10-20T18:25:53.457Z","Aborted, Not Charged","auto","No","0","0","0","0","0","0.00"
"2025-10-20T18:21:34.037Z","Included","auto","No","99829","88695","1047900","4779","1241203","0.53"
"2025-10-20T18:14:48.964Z","Included","auto","No","203266","94427","1354802","5306","1657801","0.74"
"2025-10-20T15:15:22.707Z","Included","auto","No","207494","90997","884612","3172","1186275","0.61"
"2025-10-20T14:45:34.253Z","Included","auto","No","97240","83284","2208326","5577","2394427","0.81"
"2025-10-20T14:40:24.750Z","Included","auto","No","9411","1623","152920","1268","165222","0.06"
"2025-10-20T14:27:54.652Z","Included","auto","No","10578","73917","1647155","7240","1738890","0.56"
"2025-10-20T14:21:51.818Z","Included","auto","No","11271","66885","1140940","6995","1226091","0.42"
"2025-10-20T14:16:51.588Z","Included","auto","No","66898","2411","1325433","7948","1402690","0.47"
"2025-10-20T05:29:25.418Z","Included","auto","No","1889","29403","29644","1785","62721","0.06"
"2025-10-20T05:17:00.820Z","Included","auto","No","1856","27888","27885","1026","58655","0.05"
"2025-10-20T05:07:49.405Z","Included","auto","No","24655","23949","27445","940","76989","0.07"
"2025-10-20T04:36:15.607Z","Included","auto","No","18468","3043","45609","1982","69102","0.05"
"2025-10-19T11:40:58.372Z","Included","auto","No","4537","1352","51679","792","58360","0.03"
"2025-10-16T19:03:29.840Z","Included","auto","No","36781","1240","223176","1124","262321","0.11"
"2025-10-16T18:57:19.251Z","Included","auto","No","9834","1115","73883","423","85255","0.03"
"2025-10-16T18:51:39.121Z","Included","auto","No","32745","1679","436984","3962","475370","0.18"
"2025-10-16T18:49:46.445Z","Included","auto","No","24271","9889","82468","1591","118219","0.07"
"2025-10-16T18:42:47.814Z","Included","auto","No","22347","24447","123119","1417","171330","0.10"
"2025-10-16T17:25:11.375Z","Included","auto","No","3112","1250","67283","1150","72795","0.03"
"2025-10-16T17:22:20.927Z","Included","auto","No","7250","3520","398140","2772","411682","0.13"
"2025-10-16T17:19:46.916Z","Included","auto","No","53264","4490","72668","678","131100","0.09"
"2025-10-16T17:10:58.124Z","Included","auto","No","50812","17264","737641","6279","811996","0.31"
"2025-10-16T16:38:00.514Z","Included","auto","No","29163","41528","347730","11070","429491","0.24"
"2025-10-16T16:30:15.099Z","Included","auto","No","13282","12516","159310","9784","194892","0.13"
"2025-10-16T16:27:44.848Z","Included","auto","No","4565","1515","44093","705","50878","0.02"
"2025-10-16T16:24:10.301Z","Included","auto","No","36961","5204","188341","2617","233123","0.12"
"2025-10-16T16:14:54.187Z","Included","auto","No","31367","20359","362547","6932","421205","0.20"
"2025-10-16T16:01:54.269Z","Included","auto","No","4692","9721","41051","5378","60842","0.06"
"2025-10-16T15:58:42.222Z","Included","auto","No","1782","2994","22605","1213","28594","0.02"
"2025-10-16T05:26:22.874Z","Included","auto","No","0","4961","662043","2349","669353","0.19"
"2025-10-16T05:22:29.965Z","Included","auto","No","0","2268","435984","1646","439898","0.12"
"2025-10-16T05:16:34.424Z","Included","auto","No","0","7252","649392","2084","658728","0.18"
"2025-10-16T05:13:00.249Z","Included","auto","No","0","3363","173944","309","177616","0.05"
"2025-10-16T05:07:29.530Z","Included","auto","No","2589","9143","1020435","5393","1037560","0.30"
"2025-10-16T05:02:02.037Z","Included","auto","No","0","4816","366684","1231","372731","0.11"
"2025-10-15T20:39:19.447Z","Included","auto","No","86550","11331","2452229","5656","2555766","0.77"
"2025-10-15T20:34:56.382Z","Included","auto","No","90021","82842","1499322","11405","1683590","0.66"
"2025-10-15T20:26:32.248Z","Included","auto","No","101566","19377","952879","12323","1086145","0.46"
"2025-10-15T20:16:08.450Z","Included","auto","No","81253","6918","11261","2096","101528","0.13"
"2025-10-15T20:02:03.258Z","Included","auto","No","86714","41064","1336987","30424","1495189","0.68"
"2025-10-15T20:00:35.251Z","Included","auto","No","46688","8291","11625","1215","67819","0.08"
"2025-10-15T18:32:06.461Z","Included","auto","No","45814","15532","112780","8531","182657","0.16"
"2025-10-15T18:27:06.499Z","Included","auto","No","26480","10941","7325","3792","48538","0.07"
"2025-10-15T17:41:39.997Z","Included","auto","No","4575","1401","291719","1225","298920","0.09"
"2025-10-15T17:38:55.644Z","Included","auto","No","19160","1073","86721","531","107485","0.05"
"2025-10-15T17:36:06.369Z","Included","auto","No","3391","2990","118387","760","125528","0.04"
"2025-10-15T17:34:34.454Z","Included","auto","No","2978","4457","122566","753","130754","0.04"
"2025-10-15T17:33:02.624Z","Included","auto","No","10807","1176","44326","786","57095","0.03"
"2025-10-15T16:37:41.875Z","Included","auto","No","8801","1635","124105","1363","135904","0.05"
"2025-10-15T16:25:35.671Z","Included","auto","No","43251","1194","347330","3180","394955","0.16"
"2025-10-15T15:50:41.179Z","Included","auto","No","38556","775","357867","2201","399399","0.15"
"2025-10-15T15:41:15.645Z","Included","auto","No","34389","1206","491344","2216","529155","0.18"
"2025-10-15T15:30:29.715Z","Included","auto","No","14809","1118","112128","990","129045","0.05"
"2025-10-15T15:19:28.179Z","Included","auto","No","11682","1369","163944","1918","178913","0.07"
"2025-10-15T14:59:23.634Z","Included","auto","No","8009","749","86689","1514","96961","0.04"
"2025-10-15T13:58:49.298Z","Included","auto","No","544","953","59867","219","61583","0.02"
"2025-10-15T13:56:48.484Z","Included","auto","No","1714","1057","229789","700","233260","0.07"
"2025-10-15T13:53:54.826Z","Included","auto","No","30412","1024","83684","384","115504","0.06"
"2025-10-15T13:50:48.741Z","Included","auto","No","93471","1929","1017048","2598","1115046","0.39"
"2025-10-15T13:46:31.537Z","Included","auto","No","1190","1225","72554","576","75545","0.02"
"2025-10-15T13:43:50.787Z","Included","auto","No","8741","926","184518","1412","195597","0.07"
"2025-10-15T13:40:13.251Z","Included","auto","No","7072","1057","36367","598","45094","0.02"
"2025-10-15T09:04:53.952Z","Included","auto","No","2043","7545","35646","2834","48068","0.04"
"2025-10-15T09:03:27.222Z","Included","auto","No","24219","8422","12196","2275","47112","0.06"
"2025-10-15T08:56:30.077Z","Included","auto","No","9370","20215","12199","3187","44971","0.06"
"2025-10-15T07:01:40.581Z","Included","auto","No","22917","5591","57438","9192","95138","0.11"
"2025-10-15T06:50:01.891Z","Included","auto","No","5553","1604","37113","4728","48998","0.05"
"2025-10-15T06:44:45.078Z","Included","auto","No","565","1584","11472","1018","14639","0.01"
"2025-10-14T17:18:03.109Z","Included","auto","No","11478","1522","71684","1590","86274","0.04"
"2025-10-14T17:04:48.920Z","Included","auto","No","54678","2877","405102","2340","464997","0.19"
"2025-10-14T17:00:11.423Z","Included","auto","No","61985","2270","512902","5138","582295","0.24"
"2025-10-14T16:55:27.097Z","Included","auto","No","13421","1988","432982","3697","452088","0.15"
"2025-10-14T16:53:04.622Z","Included","auto","No","7783","2784","145321","1775","157663","0.06"
"2025-10-14T16:51:35.338Z","Included","auto","No","25625","2709","78084","1756","108174","0.07"
"2025-10-14T16:48:36.846Z","Included","auto","No","40960","6655","137193","2607","187415","0.11"
"2025-10-14T16:46:10.439Z","Included","auto","No","17473","1972","160920","3741","184106","0.09"
"2025-10-14T16:42:30.310Z","Included","auto","No","14236","1868","110709","3100","129913","0.07"
"2025-10-14T16:03:52.468Z","Included","auto","No","110099","70408","1097983","19079","1297569","0.61"
"2025-10-14T15:44:07.748Z","Included","auto","No","119632","101247","811226","9323","1041428","0.53"
"2025-10-14T15:33:44.785Z","Included","auto","No","17956","2167","1714511","5263","1739897","0.49"
"2025-10-14T15:32:08.425Z","Included","auto","No","94866","1564","95103","811","192344","0.15"
"2025-10-14T15:12:30.253Z","Included","auto","No","79981","1469","264162","4034","349646","0.19"
"2025-10-14T15:03:28.472Z","Included","auto","No","74345","6593","485270","3980","570188","0.25"
"2025-10-14T14:59:50.444Z","Included","auto","No","9217","1033","68451","950","79651","0.04"
"2025-10-14T14:55:25.228Z","Included","auto","No","128712","14471","591143","3600","737926","0.35"
"2025-10-14T14:48:37.216Z","Included","auto","No","56963","1180","11508","474","70125","0.08"
"2025-10-14T14:31:21.746Z","Included","auto","No","133212","17815","595075","7985","754087","0.39"
"2025-10-14T14:27:30.818Z","Errored, Not Charged","auto","No","47203","7275","146589","4046","205113","0.13"
"2025-10-14T14:24:54.884Z","Included","auto","No","75926","5161","11740","3356","96183","0.12"
"2025-10-14T14:14:27.666Z","Included","auto","No","39559","4536","39816","2538","86449","0.08"
"2025-10-14T14:08:29.206Z","Included","auto","No","9133","14527","150751","5400","179811","0.10"
"2025-10-14T14:06:02.666Z","Included","auto","No","17735","1002","11562","816","31115","0.03"
"2025-10-14T12:17:34.683Z","Included","auto","No","30997","7807","99047","1554","139405","0.08"
"2025-10-14T12:09:41.069Z","Included","auto","No","58837","9519","183876","3694","255926","0.15"
"2025-10-14T12:04:44.812Z","Included","auto","No","18418","12119","363052","4063","397652","0.15"
"2025-10-14T12:01:40.205Z","Included","auto","No","43659","14289","102813","2510","163271","0.11"
"2025-10-14T11:59:10.810Z","Included","auto","No","14008","5729","120620","2044","142401","0.07"
"2025-10-14T11:55:35.558Z","Included","auto","No","58912","21983","351195","4521","436611","0.22"
"2025-10-14T11:53:23.079Z","Included","auto","No","38985","11129","125686","2286","178086","0.11"
"2025-10-14T11:40:14.205Z","Included","auto","No","52093","3546","85929","2147","143715","0.10"
"2025-10-13T19:45:04.951Z","Included","auto","No","369359","1591","2493727","2297","2866974","1.10"
"2025-10-13T19:38:21.333Z","Included","auto","No","6556","2038","3753364","3683","3765641","0.97"
"2025-10-13T19:36:10.055Z","Included","auto","No","328489","1249","11367","543","341648","0.42"
"2025-10-13T19:30:47.604Z","Included","auto","No","9801","2092","4674317","4495","4690705","1.21"
"2025-10-13T19:29:08.087Z","Included","auto","No","319156","1613","11481","1437","333687","0.41"
"2025-10-13T19:24:37.171Z","Included","auto","No","6501","1982","3264097","3519","3276099","0.85"
"2025-10-13T19:21:29.538Z","Included","auto","No","312975","1423","11421","835","326654","0.40"
"2025-10-13T19:11:53.992Z","Included","auto","No","313345","2163","3512453","3910","3831871","1.30"
"2025-10-13T19:06:16.743Z","Included","auto","No","306144","1624","2511737","2120","2821625","1.03"
"2025-10-13T19:06:10.312Z","Errored, Not Charged","auto","No","0","343","510","6","859","0.001"
"2025-10-13T19:00:45.937Z","Included","auto","No","297954","1616","3969543","3811","4272924","1.39"
"2025-10-13T15:42:41.298Z","Errored, Not Charged","auto","No","873436","1376","329107","1053","1204972","1.18"
"2025-10-13T14:17:44.977Z","Included","auto","No","289069","1063","10737","388","301257","0.37"
"2025-10-13T07:44:54.269Z","Errored, Not Charged","auto","No","554223","2632","20366","977","578198","0.71"
"2025-10-12T18:52:17.259Z","Included","auto","No","55638","18070","295901","5640","375249","0.20"
"2025-10-12T18:40:40.445Z","Included","auto","No","37777","21704","386542","6758","452781","0.21"
"2025-10-12T18:08:56.326Z","Included","auto","No","28541","32716","282017","4921","348195","0.18"
"2025-10-12T18:03:23.841Z","Included","auto","No","1363","1247","45524","1071","49205","0.02"
"2025-10-12T18:01:43.117Z","Included","auto","No","9192","1648","36391","1291","48522","0.03"
"2025-10-12T17:57:44.524Z","Included","auto","No","13498","8934","208309","4265","235006","0.11"
"2025-10-12T17:55:26.172Z","Included","auto","No","8409","6600","170288","3087","188384","0.08"
"2025-10-12T17:53:29.037Z","Included","auto","No","2022","3804","73816","1154","80796","0.03"
"2025-10-12T17:51:48.533Z","Included","auto","No","9701","1478","39406","963","51548","0.03"
"2025-10-12T14:26:39.063Z","Errored, Not Charged","auto","No","679","1008","23934","283","25904","0.01"
"2025-10-12T14:24:02.253Z","Included","auto","No","1860","1067","22704","1029","26660","0.02"
"2025-10-12T14:22:01.151Z","Included","auto","No","6743","1230","15561","1982","25516","0.03"
"2025-10-12T14:18:49.243Z","Included","auto","No","201970","17860","11743","852","232425","0.28"
"2025-10-12T14:00:30.848Z","Included","auto","No","570252","40089","1163378","22553","1796272","1.19"
"2025-10-12T13:56:45.622Z","Included","auto","No","327987","21249","13049","921","363206","0.45"
"2025-10-12T13:51:17.488Z","Included","auto","No","1599","14179","338746","3100","357624","0.12"
"2025-10-12T13:49:09.522Z","Included","auto","No","15025","15112","324507","1528","356172","0.13"
"2025-10-12T13:47:02.992Z","Included","auto","No","311363","28541","13068","1436","354408","0.44"
"2025-10-12T13:31:54.175Z","Included","auto","No","315138","162648","181561","11082","670429","0.71"
"2025-10-12T13:16:29.399Z","Included","auto","No","96931","3305","117066","1004","218306","0.16"
"2025-10-12T13:10:19.448Z","Included","auto","No","94314","158373","1915040","14683","2182410","0.88"
"2025-10-12T13:03:24.430Z","Included","auto","No","156446","4971","12119","1256","174792","0.21"
"2025-10-12T12:54:32.115Z","Included","auto","No","158635","6588","176030","2465","343718","0.27"
"2025-10-12T12:46:59.102Z","Included","auto","No","82851","14159","1061095","3796","1161901","0.41"
"2025-10-12T12:44:17.893Z","Included","auto","No","150387","82219","881179","3843","1117628","0.53"
"2025-10-12T12:37:01.709Z","Included","auto","No","71984","4983","12159","1613","90739","0.11"
"2025-10-12T12:27:48.691Z","Included","auto","No","76413","69873","2453247","15507","2615040","0.89"
"2025-10-12T12:25:13.908Z","Included","auto","No","826","996","41276","2980","46078","0.03"
"2025-10-12T12:22:42.741Z","Included","auto","No","12042","1465","29920","1207","44634","0.03"
"2025-10-12T12:18:39.268Z","Included","auto","No","17372","12828","40594","1765","72559","0.06"
"2025-10-12T12:02:54.693Z","Included","auto","No","63266","16762","825765","6751","912544","0.35"
"2025-10-12T11:58:49.049Z","Included","auto","No","21475","13031","181889","3173","219568","0.11"
"2025-10-12T11:45:04.570Z","Included","auto","No","51910","33655","402072","12299","499936","0.28"
"2025-10-11T16:34:03.474Z","Included","auto","No","0","2009","54475","1393","57877","0.02"
"2025-10-11T16:28:17.080Z","Included","auto","No","5702","33173","1140629","4152","1183656","0.36"
"2025-10-11T16:20:20.020Z","Included","auto","No","124500","48092","2187122","13948","2373662","0.85"
"2025-10-11T16:11:55.133Z","Included","auto","No","42720","17588","785273","5558","851139","0.31"
"2025-10-11T16:07:30.225Z","Included","auto","No","0","12157","485139","4955","502251","0.17"
"2025-10-11T15:59:32.925Z","Included","auto","No","0","4113","128628","2030","134771","0.05"
"2025-10-11T15:55:15.420Z","Included","auto","No","749","19216","429267","6888","456120","0.17"
"2025-10-11T15:23:55.657Z","Included","auto","No","0","2020","403504","892","406416","0.11"
"2025-10-11T15:17:57.379Z","Included","auto","No","0","31564","1558607","7242","1597413","0.47"
"2025-10-11T15:16:01.360Z","Included","auto","No","0","15648","751099","4906","771653","0.24"
"2025-10-11T15:12:41.879Z","Included","auto","No","0","77322","105397","4558","187277","0.15"
"2025-10-11T14:31:30.453Z","Included","auto","No","5648","1944","93278","6470","107340","0.07"
"2025-10-11T14:28:39.732Z","Included","auto","No","36490","1786","56772","5911","100959","0.10"
"2025-10-11T14:26:26.265Z","Errored, Not Charged","auto","No","40545","16996","141184","2082","200807","0.12"
"2025-10-11T14:22:31.956Z","Included","auto","No","33438","24792","67123","4073","129426","0.11"
"2025-10-11T14:19:08.253Z","Included","auto","No","3704","23378","19693","2412","49187","0.05"
"2025-10-11T12:58:52.072Z","Included","auto","No","5029","14150","33968","13374","66521","0.11"
"2025-10-11T12:50:54.502Z","Included","auto","No","8233","13789","523124","7656","552802","0.20"
"2025-10-11T12:46:01.693Z","Included","auto","No","1227","1832","260402","2025","265486","0.08"
"2025-10-11T12:42:57.087Z","Included","auto","No","4675","1851","255722","1199","263447","0.08"
"2025-10-11T12:35:53.015Z","Included","auto","No","6013","4849","1532786","4243","1547891","0.42"
"2025-10-11T12:31:12.628Z","Included","auto","No","1276","1610","253030","1612","257528","0.08"
"2025-10-11T12:29:34.530Z","Included","auto","No","1333","1786","251607","819","255545","0.07"
"2025-10-11T12:24:40.068Z","Included","auto","No","4813","2268","998579","1038","1006698","0.26"
"2025-10-11T12:22:05.060Z","Included","auto","No","237979","3699","258026","2983","502687","0.38"
"2025-10-11T12:14:24.695Z","Included","auto","No","238022","24802","4006037","6603","4275464","1.37"
"2025-10-11T09:09:02.252Z","Included","auto","No","3530","4405","438425","3617","449977","0.14"
"2025-10-11T09:04:57.342Z","Included","auto","No","3180","5845","1524587","2034","1535646","0.40"
"2025-10-11T09:01:10.056Z","Included","auto","No","205671","2312","11396","489","219868","0.27"
"2025-10-11T08:38:26.301Z","Included","auto","No","205942","5901","221288","873","434004","0.33"
"2025-10-11T08:29:21.329Z","Included","auto","No","201714","12037","1668259","3566","1885576","0.71"
"2025-10-11T08:23:12.602Z","Included","auto","No","30563","39051","3406781","5235","3481630","0.97"
"2025-10-11T08:17:51.652Z","Included","auto","No","1961","31224","2136349","5938","2175472","0.61"
"2025-10-11T08:15:27.248Z","Included","auto","No","321","4415","838355","2026","845117","0.23"
"2025-10-11T08:12:01.607Z","Included","auto","No","921","3244","543421","1611","549197","0.15"
"2025-10-11T08:10:23.408Z","Included","auto","No","0","2073","135173","1048","138294","0.04"
"2025-10-11T07:54:25.455Z","Included","auto","No","2785","3386","524703","1891","532765","0.15"
"2025-10-11T07:41:42.798Z","Included","auto","No","552","9578","1270632","3307","1284069","0.35"
"2025-10-11T07:39:19.418Z","Included","auto","No","4494","3907","366404","2200","377005","0.12"
"2025-10-11T07:36:06.118Z","Included","auto","No","0","5333","718658","2907","726898","0.20"
"2025-10-11T07:27:11.229Z","Included","auto","No","0","5479","345504","2108","353091","0.11"
"2025-10-11T07:22:44.031Z","Included","auto","No","927","6446","664396","3063","674832","0.19"
"2025-10-11T07:19:03.716Z","Included","auto","No","0","5168","534131","2387","541686","0.15"
"2025-10-11T07:06:47.449Z","Included","auto","No","1240","3749","43594","1496","50079","0.03"
"2025-10-11T06:52:57.930Z","Included","auto","No","0","1706","106177","661","108544","0.03"
"2025-10-11T06:40:46.077Z","Included","auto","No","37777","75300","1348944","12734","1474755","0.55"
"2025-10-11T06:31:26.758Z","Included","auto","No","33234","27809","812452","11115","884610","0.35"
"2025-10-11T06:21:26.291Z","Included","auto","No","647","16792","67736","2467","87642","0.05"
"2025-10-10T20:48:44.827Z","Included","auto","No","15434","1110","12092","597","29233","0.03"
"2025-10-10T20:43:11.695Z","Included","auto","No","59215","2789","890880","12408","965292","0.37"
"2025-10-10T20:37:05.839Z","Included","auto","No","41331","26461","70496","5720","144008","0.14"
"2025-10-10T20:30:58.496Z","Included","auto","No","12561","24938","2001863","5429","2044791","0.58"
"2025-10-10T20:25:30.224Z","Included","auto","No","176678","34002","1843725","6070","2060475","0.76"
"2025-10-10T20:20:12.245Z","Included","auto","No","148655","3067","12248","1785","165755","0.20"
"2025-10-10T20:10:38.085Z","Included","auto","No","152675","1773","615061","19036","788545","0.46"
"2025-10-10T20:03:45.086Z","Included","auto","No","126597","1747","1061186","15791","1205321","0.52"
"2025-10-10T19:56:06.235Z","Included","auto","No","9677","2026","108812","908","121423","0.05"
"2025-10-10T19:50:02.764Z","Included","auto","No","10526","1660","542100","4733","559019","0.18"
"2025-10-10T19:45:11.101Z","Included","auto","No","93812","2963","12307","1214","110296","0.13"
"2025-10-10T19:32:57.551Z","Included","auto","No","103143","2036","952441","7934","1065554","0.42"
"2025-10-10T19:18:33.437Z","Included","auto","No","74230","2682","175525","2813","255250","0.16"
"2025-10-10T19:01:09.520Z","Included","auto","No","69444","2852","741569","5521","819386","0.31"
"2025-10-10T18:44:45.557Z","Included","auto","No","141197","67618","790192","14691","1013698","0.55"
"2025-10-10T18:27:00.093Z","Included","auto","No","101331","1740","742005","3417","848493","0.33"
"2025-10-10T18:01:16.571Z","Included","auto","No","98697","1771","1176126","3746","1280340","0.44"
"2025-10-10T17:54:20.722Z","Included","auto","No","1726","1766","93768","1128","98388","0.03"
"2025-10-10T17:47:06.274Z","Included","auto","No","8180","1892","1493881","3931","1507884","0.41"
"2025-10-10T17:40:46.789Z","Included","auto","No","3848","1452","410907","2168","418375","0.12"
"2025-10-10T17:32:46.397Z","Included","auto","No","77181","27906","1271770","5989","1382846","0.49"
"2025-10-10T15:19:07.241Z","Included","auto","No","49192","0","358010","910","408112","0.16"
"2025-10-10T15:05:58.952Z","Included","auto","No","55695","109707","1646484","23204","1835090","0.76"
"2025-10-10T14:32:36.777Z","Included","auto","No","17118","17072","2202551","7689","2244430","0.64"
"2025-10-10T14:25:36.599Z","Included","auto","No","200109","24845","2451180","6959","2683093","0.94"
"2025-10-10T14:14:28.995Z","Included","auto","No","185426","33733","3071220","17522","3307901","1.15"
"2025-10-10T14:05:35.580Z","Included","auto","No","2175","1587","161403","2861","168026","0.06"
"2025-10-10T14:02:21.193Z","Included","auto","No","7063","6436","953181","1876","968556","0.27"
"2025-10-10T13:57:35.491Z","Included","auto","No","15711","22196","1464720","6991","1509618","0.46"
"2025-10-10T13:53:00.859Z","Included","auto","No","15979","19435","1453032","7779","1496225","0.45"
"2025-10-10T13:47:40.883Z","Included","auto","No","111684","34315","2569661","10441","2726101","0.89"
"2025-10-10T13:39:30.020Z","Included","auto","No","5383","1162","192321","4353","203219","0.08"
"2025-10-10T13:32:54.721Z","Included","auto","No","85074","2069","1005229","5109","1097481","0.39"
"2025-10-10T13:20:18.107Z","Included","auto","No","15375","1488","976852","8323","1002038","0.32"
"2025-10-10T13:13:52.809Z","Included","auto","No","57970","1204","529036","3499","591709","0.23"
"2025-10-10T13:10:42.462Z","Included","auto","No","29977","642","184203","1429","216251","0.09"
"2025-10-10T13:01:41.376Z","Included","auto","No","115272","571","701663","1950","819456","0.33"
"2025-10-10T09:48:18.660Z","Included","auto","No","18624","1048","1089987","3969","1113628","0.32"
"2025-10-10T09:43:05.785Z","Included","auto","No","98360","2046","1413149","5527","1519082","0.51"
"2025-10-10T09:35:36.149Z","Included","auto","No","116225","6627","10943","1433","135228","0.16"
"2025-10-10T09:23:13.423Z","Included","auto","No","123114","101883","3855083","28022","4108102","1.41"
"2025-10-10T09:20:51.096Z","Included","auto","No","2815","319","66715","4984","74833","0.05"
"2025-10-10T09:16:01.185Z","Included","auto","No","66715","1939","804","3393","72851","0.11"
"2025-10-10T09:05:59.573Z","Included","auto","No","1503","15360","102129","2423","121415","0.06"
"2025-10-10T09:02:33.507Z","Aborted, Not Charged","auto","No","0","0","0","0","0","0.00"
"2025-10-10T08:57:37.451Z","Included","auto","No","49403","714","754","1718","52589","0.07"
"2025-10-10T08:50:06.909Z","Included","auto","No","37209","222","11807","851","50089","0.05"
"2025-10-10T07:47:41.187Z","Included","auto","No","0","34938","287071","3166","325175","0.13"
"2025-10-10T07:43:47.498Z","Included","auto","No","0","11607","195752","3233","210592","0.08"
"2025-10-09T22:14:23.914Z","Included","auto","No","65507","966","10859","706","78038","0.09"
"2025-10-09T22:11:28.921Z","Included","auto","No","49585","34088","603482","4135","691290","0.28"
"2025-10-09T22:02:34.735Z","Included","auto","No","25089","43670","900487","8730","977976","0.36"
"2025-10-09T21:56:42.300Z","Included","auto","No","16831","33793","199320","3325","253269","0.13"
"2025-10-09T21:36:39.910Z","Included","auto","No","93477","2384","10851","737","107449","0.13"
"2025-10-09T21:26:41.084Z","Included","auto","No","107839","3385","2645452","14446","2771122","0.89"
"2025-10-09T21:21:44.228Z","Included","auto","No","51299","1064","379554","6740","438657","0.20"
"2025-10-09T21:13:50.675Z","Included","auto","No","50674","10519","164464","2715","228372","0.13"
"2025-10-09T20:56:27.881Z","Included","auto","No","87770","2299","2353593","15599","2459261","0.79"
"2025-10-09T20:49:02.576Z","Included","auto","No","28447","1991","921255","11577","963270","0.34"
"2025-10-09T20:48:21.022Z","Errored, Not Charged","auto","No","0","0","0","0","0","0.00"
"2025-10-09T20:43:26.573Z","Included","auto","No","30474","10149","235262","4141","280026","0.13"
"2025-10-09T20:29:29.419Z","Included","auto","No","323150","1739","4904551","7693","5237133","1.68"
"2025-10-09T20:20:07.481Z","Included","auto","No","309036","1535","2850866","4614","3166051","1.13"
"2025-10-09T20:13:42.746Z","Included","auto","No","11004","1549","2450227","4578","2467358","0.66"
"2025-10-09T20:09:22.282Z","Included","auto","No","289704","1928","10997","1564","304193","0.38"
"2025-10-09T20:04:03.899Z","Included","auto","No","290447","1475","2978733","4821","3275476","1.14"
"2025-10-09T19:55:59.047Z","Included","auto","No","281432","1632","3406668","8717","3698449","1.26"
"2025-10-09T19:47:15.656Z","Included","auto","No","21727","1941","5565569","7184","5596421","1.46"
"2025-10-09T19:43:29.845Z","Included","auto","No","6842","1249","1267982","2124","1278197","0.34"
"2025-10-09T19:40:55.257Z","Included","auto","No","242339","808","260246","697","504090","0.37"
"2025-10-09T19:28:41.001Z","Included","auto","No","45464","648","11386748","18647","11451507","3.02"
"2025-10-09T19:25:01.541Z","Included","auto","No","4103","1028","205220","582","210933","0.06"
"2025-10-09T19:20:08.021Z","Included","auto","No","7862","1082","613581","2560","625085","0.18"
"2025-10-09T19:15:18.134Z","Included","auto","No","12282","1044","597066","2890","613282","0.18"
"2025-10-09T19:10:39.668Z","Included","auto","No","377680","1174","608647","4862","992363","0.65"
"2025-10-09T19:04:30.026Z","Included","auto","No","15400","1182","742290","4188","763060","0.23"
"2025-10-09T18:59:48.612Z","Included","auto","No","175258","1591","1101829","5999","1284677","0.53"
"2025-10-09T18:51:07.218Z","Included","auto","No","165689","588","881442","2948","1050667","0.45"
"2025-10-09T17:43:08.204Z","Included","auto","No","161260","1194","850440","4661","1017555","0.44"
"2025-10-09T17:39:31.990Z","Included","auto","No","17181","5393","1104740","3948","1131262","0.33"
"2025-10-09T17:35:36.179Z","Included","auto","No","15563","1615","1189082","4666","1210926","0.35"
"2025-10-09T17:29:43.739Z","Included","auto","No","16681","1432","981372","4887","1004372","0.30"
"2025-10-09T17:23:28.070Z","Included","auto","No","16863","1425","922293","5214","945795","0.28"
"2025-10-09T17:18:15.742Z","Included","auto","No","118560","1510","382864","6624","509558","0.29"
"2025-10-09T17:02:08.577Z","Included","auto","No","23335","1549","1919986","11827","1956697","0.58"
"2025-10-09T16:59:01.601Z","Included","auto","No","86969","1231","10945","1984","101129","0.12"
"2025-10-09T16:35:15.124Z","Included","auto","No","22888","1679","1422650","8106","1455323","0.44"
"2025-10-09T16:32:44.602Z","Included","auto","No","71306","1463","404085","2647","479501","0.21"
"2025-10-09T13:18:59.831Z","Included","auto","No","62288","13284","712728","4230","792530","0.30"
"2025-10-09T13:12:41.911Z","Included","auto","No","57096","2336","941470","9739","1010641","0.37"
"2025-10-09T13:07:29.283Z","Included","auto","No","29758","15810","196415","5327","247310","0.14"
"2025-10-09T12:45:21.563Z","Errored, Not Charged","auto","No","33202","7946","158416","3287","202851","0.11"
"2025-10-09T12:42:25.701Z","Included","auto","No","25573","10291","21219","2084","59167","0.06"
"2025-10-09T12:28:56.036Z","Included","auto","No","9355","986","85496","915","96752","0.04"
"2025-10-09T12:25:07.287Z","Errored, Not Charged","auto","No","9537","944","340209","3019","353709","0.12"
"2025-10-09T12:20:42.012Z","Included","auto","No","6672","382","107687","1443","116184","0.04"
"2025-10-09T12:18:59.748Z","Included","auto","No","11197","583","164532","2228","178540","0.07"
"2025-10-09T12:16:27.399Z","Included","auto","No","14857","1199","131958","1693","149707","0.06"
"2025-10-09T12:15:11.847Z","Included","auto","No","32695","9624","37225","597","80141","0.07"
"2025-10-09T12:09:53.428Z","Included","auto","No","44997","1218","300650","4470","351335","0.16"
"2025-10-09T12:07:24.889Z","Included","auto","No","58600","9813","113676","1593","183682","0.12"
"2025-10-09T12:00:37.099Z","Included","auto","No","140932","1164","461187","2629","605912","0.31"
"2025-10-09T10:11:47.648Z","Included","auto","No","14769","1639","1275079","5927","1297414","0.37"
"2025-10-09T10:06:54.062Z","Included","auto","No","127233","1632","825212","2943","957020","0.39"
"2025-10-09T10:03:19.146Z","Included","auto","No","122763","2698","1559826","4677","1689964","0.57"
"2025-10-09T10:00:30.529Z","Included","auto","No","112886","13366","1074332","5658","1206242","0.46"
"2025-10-09T09:29:07.940Z","Included","auto","No","104465","10143","1664764","6508","1785880","0.60"
"2025-10-08T16:56:14.750Z","Included","auto","No","95042","7105","849069","9572","960788","0.40"
"2025-10-08T16:50:12.273Z","Included","auto","No","71828","1820","639125","3784","716557","0.27"
"2025-10-08T16:36:39.638Z","Included","auto","No","39748","2501","975985","16323","1034557","0.39"
"2025-10-08T16:28:31.128Z","Included","auto","No","26657","1171","252663","4119","284610","0.12"
"2025-10-08T16:23:17.172Z","Included","auto","No","24696","10452","121556","3487","160191","0.10"
"2025-10-08T16:15:09.027Z","Included","auto","No","6104","9617","10804","584","27109","0.03"
"2025-10-08T15:51:08.037Z","Included","auto","No","69659","2531","1905866","9185","1987241","0.62"
"2025-10-08T15:41:44.481Z","Included","auto","No","39888","1634","543904","7258","592684","0.23"
"2025-10-08T15:37:30.787Z","Included","auto","No","27262","10617","229166","4462","271507","0.13"
"2025-10-08T15:30:27.070Z","Included","auto","No","24350","9881","178735","4039","217005","0.11"
"2025-10-08T15:15:06.742Z","Included","auto","No","34135","820","66774","942","102671","0.07"
"2025-10-08T14:24:28.270Z","Included","auto","No","21181","2985","72287","1442","97895","0.06"
"2025-10-08T13:30:06.079Z","Included","auto","No","3406","2544","83984","1456","91390","0.04"
"2025-10-08T13:28:41.286Z","Included","auto","No","18392","2684","118837","2478","142391","0.07"
"2025-10-08T13:13:22.966Z","Included","auto","No","59742","1203","10902","1344","73191","0.09"
"2025-10-08T13:08:05.500Z","Included","auto","No","7933","21683","685940","5246","720802","0.24"
"2025-10-08T13:07:55.360Z","Errored, Not Charged","auto","No","0","0","0","0","0","0.00"
"2025-10-08T13:03:15.615Z","Included","auto","No","49863","12598","545068","5149","612678","0.25"
"2025-10-08T12:59:36.906Z","Included","auto","No","42256","13546","243249","3618","302669","0.15"
"2025-10-08T12:49:00.037Z","Included","auto","No","200275","1098","429376","1898","632647","0.37"
"2025-10-08T12:43:38.239Z","Included","auto","No","197983","1610","2448128","6651","2654372","0.90"
"2025-10-08T12:39:47.790Z","Errored, Not Charged","auto","No","26456","765","3149124","10762","3187107","0.89"
"2025-10-08T12:37:36.480Z","Included","auto","No","4755","874","511615","2575","519819","0.15"
"2025-10-08T12:36:12.688Z","Included","auto","No","5906","773","163229","676","170584","0.05"
"2025-10-08T12:32:35.219Z","Included","auto","No","168318","1581","496715","2781","669395","0.35"
"2025-10-08T12:27:26.352Z","Included","auto","No","152330","1404","1120946","5943","1280623","0.51"
"2025-10-08T12:18:40.438Z","Included","auto","No","142962","5019","1722474","7862","1878317","0.66"
"2025-10-08T07:46:49.596Z","Included","auto","No","117002","37243","1573893","6531","1734669","0.63"
"2025-10-08T07:23:17.191Z","Included","auto","No","103564","17350","980511","5242","1106667","0.43"
"2025-10-08T07:16:41.334Z","Included","auto","No","19393","22991","1481746","7582","1531712","0.47"
"2025-10-08T07:11:22.978Z","Included","auto","No","7882","8257","406743","4435","427317","0.15"
"2025-10-08T07:07:30.814Z","Included","auto","No","9775","6460","300068","2448","318751","0.11"
"2025-10-08T07:02:50.370Z","Included","auto","No","66521","11982","656475","5202","740180","0.29"
"2025-10-08T06:55:19.292Z","Included","auto","No","56238","14571","385651","2683","459143","0.20"
"2025-10-08T06:48:03.684Z","Included","auto","No","51534","52429","851608","16843","972414","0.44"
"2025-10-08T06:36:28.061Z","Included","auto","No","18899","25409","981166","7370","1032844","0.34"
"2025-10-08T06:31:01.828Z","Included","auto","No","12033","6917","387709","3511","410170","0.14"
"2025-10-08T06:25:13.905Z","Included","auto","No","88106","11452","468229","6420","574207","0.28"
"2025-10-08T06:05:48.787Z","Included","auto","No","79498","88834","1140127","12914","1321373","0.57"
"2025-10-08T05:29:49.635Z","Included","auto","No","55784","12365","495382","3010","566541","0.23"
"2025-10-07T21:18:46.293Z","Included","auto","No","6169","554","240285","1548","248556","0.08"
"2025-10-07T21:12:49.989Z","Included","auto","No","29508","1628","840714","4130","875980","0.27"
"2025-10-07T21:00:23.305Z","Included","auto","No","73594","564","248508","1327","323993","0.16"
"2025-10-07T20:48:45.914Z","Included","auto","No","1210","510","312598","853","315171","0.09"
"2025-10-07T20:44:13.383Z","Included","auto","No","782","0","76571","208","77561","0.02"
"2025-10-07T20:40:15.456Z","Included","auto","No","6578","181","298552","442","305753","0.09"
"2025-10-07T20:37:28.617Z","Included","auto","No","8668","1079","855592","1651","866990","0.24"
"2025-10-07T20:32:18.450Z","Included","auto","No","40246","902","435838","2304","479290","0.17"
"2025-10-07T20:26:16.359Z","Included","auto","No","75119","626","216352","1744","293841","0.16"
"2025-10-07T20:21:14.030Z","Included","auto","No","6715","836","905617","2108","915276","0.25"
"2025-10-07T20:15:35.647Z","Included","auto","No","2473","585","655902","945","659905","0.17"
"2025-10-07T20:06:07.939Z","Included","auto","No","100399","910","328096","1467","430872","0.22"
"2025-10-07T19:52:24.711Z","Included","auto","No","5037","627","508761","2456","516881","0.15"
"2025-10-07T19:47:10.888Z","Included","auto","No","5990","784","864917","1952","873643","0.24"
"2025-10-07T19:38:39.123Z","Included","auto","No","8296","593","798395","4216","811500","0.24"
"2025-10-07T19:33:43.941Z","Included","auto","No","8313","844","897708","4335","911200","0.26"
"2025-10-07T19:27:09.929Z","Included","auto","No","9750","1025","1161861","2286","1174922","0.32"
"2025-10-07T19:21:48.902Z","Included","auto","No","9360","888","829144","2671","842063","0.24"
"2025-10-07T19:13:31.467Z","Included","auto","No","10293","929","1015886","3255","1030363","0.29"
"2025-10-07T19:04:28.132Z","Included","auto","No","44623","0","762262","3836","810721","0.27"
"2025-10-07T18:51:59.431Z","Included","auto","No","6590","942","243703","1221","252456","0.08"
"2025-10-07T18:45:17.022Z","Included","auto","No","24432","849","101929","993","128203","0.06"
"2025-10-07T18:24:59.888Z","Included","auto","No","12718","865","1602681","6299","1622563","0.46"
"2025-10-07T18:18:44.704Z","Included","auto","No","6638","0","521130","2690","530458","0.15"
"2025-10-07T18:15:45.647Z","Included","auto","No","2450","636","236726","862","240674","0.07"
"2025-10-07T18:11:09.892Z","Included","auto","No","2441","740","268969","999","273149","0.08"
"2025-10-07T18:05:21.103Z","Included","auto","No","25094","0","326847","2869","354810","0.13"
"2025-10-07T18:02:58.919Z","Included","auto","No","25610","842","220480","1234","248166","0.10"
"2025-10-07T17:59:23.506Z","Included","auto","No","18276","4055","1449279","10834","1482444","0.46"
"2025-10-07T17:57:37.300Z","Included","auto","No","108970","915","791640","4465","905990","0.36"
"2025-10-07T17:50:43.818Z","Included","auto","No","11293","2104","601042","5785","620224","0.20"
"2025-10-07T17:47:41.718Z","Included","auto","No","1457","1892","109195","1083","113627","0.04"
"2025-10-07T17:46:46.472Z","Included","auto","No","2057","802","69170","803","72832","0.03"
"2025-10-07T17:41:00.076Z","Included","auto","No","11767","1607","737109","4934","755417","0.23"
"2025-10-07T17:40:14.437Z","Included","auto","No","14914","0","28323","241","43478","0.03"
"2025-10-07T13:10:44.557Z","Included","auto","No","16693","1268","1420964","6828","1445753","0.42"
"2025-10-07T13:06:27.403Z","Included","auto","No","81102","688","611010","1895","694695","0.27"
"2025-10-07T13:01:58.385Z","Included","auto","No","8460","795","321611","5282","336148","0.12"
"2025-10-07T12:50:48.011Z","Included","auto","No","76382","957","448998","2867","529204","0.23"
"2025-10-07T12:44:28.500Z","Included","auto","No","63811","547","351658","2365","418381","0.18"
"2025-10-07T12:39:25.477Z","Included","auto","No","4857","628","419740","1197","426422","0.12"
"2025-10-07T12:35:19.830Z","Included","auto","No","1760","674","114055","861","117350","0.04"
"2025-10-07T12:29:50.632Z","Included","auto","No","7590","624","417764","3356","429334","0.13"
"2025-10-07T12:27:02.781Z","Included","auto","No","6802","560","359310","2929","369601","0.12"
"2025-10-07T12:23:16.212Z","Included","auto","No","34393","591","49375","872","85231","0.06"
"2025-10-07T11:55:07.834Z","Included","auto","No","33268","0","857781","7441","898490","0.30"
"2025-10-07T11:49:25.209Z","Included","auto","No","9933","2054","764141","3059","779187","0.22"
"2025-10-07T11:42:51.558Z","Included","auto","No","14851","1005","664821","3827","684504","0.21"
"2025-10-07T11:40:13.036Z","Included","auto","No","19745","882","257823","1544","279994","0.10"
"2025-10-07T09:08:46.646Z","Included","gemini-2.5-pro","No","0","106779","110878","743","218400","0.17"
"2025-10-07T09:08:35.683Z","Errored, Not Charged","gemini-2.5-pro","No","0","0","0","0","0","0.00"
"2025-10-07T08:37:12.813Z","Included","gemini-2.5-pro","No","0","106694","774","937","108405","0.14"
"2025-10-07T08:27:04.095Z","Included","gemini-2.5-pro","No","0","104918","755","866","106539","0.14"
"2025-10-07T08:23:21.012Z","Included","gemini-2.5-pro","No","0","99030","4665","693","104388","0.13"
"2025-10-07T08:12:28.827Z","Included","gemini-2.5-pro","No","0","96623","762","913","98298","0.13"
"2025-10-07T07:59:11.115Z","Included","gemini-2.5-pro","No","0","88450","4627","585","93662","0.12"
"2025-10-07T07:56:41.671Z","Included","gemini-2.5-pro","No","0","90273","743","757","91773","0.12"
"2025-10-07T07:34:27.455Z","Included","gemini-2.5-pro","No","0","85391","4627","557","90575","0.11"
"2025-10-07T06:52:08.590Z","Included","gemini-2.5-pro","No","0","5215","82972","972","89159","0.04"
"2025-10-07T06:50:35.764Z","Included","gemini-2.5-pro","No","0","83785","693","470","84948","0.11"
"2025-10-07T06:39:23.519Z","Included","gemini-2.5-pro","No","0","82673","737","699","84109","0.11"
"2025-10-07T06:31:57.571Z","Included","gemini-2.5-pro","No","0","81332","762","922","83016","0.11"
"2025-10-07T06:23:21.290Z","Included","gemini-2.5-pro","No","0","64390","4643","942","69975","0.09"
"2025-10-07T06:16:46.832Z","Included","gemini-2.5-pro","No","0","5090","62712","645","68447","0.03"
"2025-10-07T06:13:03.690Z","Included","gemini-2.5-pro","No","0","61742","4628","848","67218","0.09"
"2025-10-07T06:00:56.061Z","Included","gemini-2.5-pro","No","0","64189","762","886","65837","0.09"
"2025-10-07T05:54:31.565Z","Included","gemini-2.5-pro","No","0","63184","739","672","64595","0.09"
"2025-10-07T05:49:59.855Z","Included","gemini-2.5-pro","No","0","65877","58680","1549","126106","0.11"
"2025-10-07T04:46:45.140Z","Included","gemini-2.5-pro","No","0","59635","764","943","61342","0.08"
"2025-10-07T04:42:48.924Z","Included","gemini-2.5-pro","No","0","57776","776","1020","59572","0.08"
"2025-10-07T04:30:39.681Z","Included","gemini-2.5-pro","No","0","55907","750","797","57454","0.08"
"2025-10-06T14:20:39.153Z","Included","auto","No","0","107198","455207","1727","564132","0.26"
"2025-10-06T14:14:37.335Z","Included","auto","No","44305","44820","161638","716","251479","0.16"
"2025-10-06T14:03:34.342Z","Included","auto","No","0","37023","1101312","5056","1143391","0.35"
"2025-10-06T13:55:28.831Z","Included","auto","No","10424","236","73295","454","84409","0.03"
"2025-10-06T13:51:26.241Z","Included","auto","No","9591","216","51370","430","61607","0.03"
"2025-10-06T13:36:40.014Z","Included","auto","No","35007","730","537130","3672","576539","0.20"
"2025-10-06T13:29:02.516Z","Included","auto","No","7542","41130","694478","2415","745565","0.25"
"2025-10-06T13:23:18.883Z","Included","auto","No","41113","0","1275478","6624","1323215","0.41"
"2025-10-06T13:19:46.399Z","Included","auto","No","34541","25648","124237","2618","187044","0.12"
"2025-10-06T13:15:03.663Z","Included","auto","No","28304","1498","789118","4936","823856","0.26"
"2025-10-06T13:08:52.051Z","Included","auto","No","56054","53439","496146","2876","608515","0.28"
"2025-10-06T12:57:56.784Z","Included","auto","No","48870","708","494757","5213","549548","0.22"
"2025-10-06T12:17:40.971Z","Included","auto","No","12693","195","45982","548","59418","0.03"
"2025-10-06T07:21:51.207Z","Included","gemini-2.5-pro","No","0","49529","50573","348","100450","0.03"
"2025-10-06T07:17:53.824Z","Included","gemini-2.5-pro","No","0","98685","50929","1653","151267","0.10"
"2025-10-06T07:10:29.325Z","Included","gemini-2.5-pro","No","0","86324","4552","1310","92186","0.07"
"2025-10-06T07:05:24.004Z","Included","gemini-2.5-pro","No","0","78528","4502","1099","84129","0.07"
"2025-10-06T06:58:29.691Z","Included","gemini-2.5-pro","No","0","73996","4533","1388","79917","0.07"
"2025-10-06T06:55:26.279Z","Included","gemini-2.5-pro","No","0","74186","734","1689","76609","0.07"
"2025-10-06T06:50:41.460Z","Included","gemini-2.5-pro","No","0","34531","34667","582","69780","0.03"
"2025-10-06T06:49:26.169Z","Included","gemini-2.5-pro","No","0","66467","699","446","67612","0.06"
"2025-10-06T06:48:00.094Z","Included","gemini-2.5-pro","No","0","60647","4468","830","65945","0.05"
"2025-10-06T06:44:50.508Z","Included","gemini-2.5-pro","No","0","28412","34426","817","63655","0.02"
"2025-10-06T06:39:56.377Z","Included","gemini-2.5-pro","No","0","54988","4478","2078","61544","0.05"
"2025-10-06T06:32:03.907Z","Included","gemini-2.5-pro","No","0","51065","4453","1656","57174","0.05"
"2025-10-06T06:28:41.090Z","Included","gemini-2.5-pro","No","0","79407","4405","2143","85955","0.09"
"2025-10-06T06:23:20.610Z","Included","gemini-2.5-pro","No","0","50740","24396","1020","76156","0.06"
"2025-10-06T06:19:11.573Z","Included","gemini-2.5-pro","No","0","34788","666","257","35711","0.03"
"2025-10-06T06:04:27.822Z","Included","gemini-2.5-pro","No","0","10272","3374","3526","17172","0.05"
"2025-10-05T19:03:22.593Z","Included","auto","No","85888","98077","819356","2049","1005370","0.45"
"2025-10-05T18:58:32.141Z","Included","auto","No","179656","102866","574321","1318","858161","0.50"
"2025-10-05T18:53:57.846Z","Included","auto","No","78987","99077","827463","1689","1007216","0.44"
"2025-10-05T18:49:30.988Z","Included","auto","No","74250","93988","1119452","1614","1289304","0.50"
"2025-10-05T18:40:49.440Z","Included","auto","No","70087","90787","659754","2049","822677","0.38"
"2025-10-05T18:38:24.224Z","Included","auto","No","65811","87002","429303","2254","584370","0.31"
"2025-10-05T18:33:10.356Z","Included","auto","No","177354","82270","766387","2232","1028243","0.53"
"2025-10-05T18:10:20.232Z","Included","auto","No","16684","72393","1105620","2807","1197504","0.40"
"2025-10-05T18:05:05.421Z","Included","auto","No","70607","54781","1427125","2951","1555464","0.53"
"2025-10-05T17:57:32.688Z","Included","auto","No","163655","112803","1912867","8254","2197579","0.87"
"2025-10-05T17:50:11.599Z","Included","auto","No","22893","103182","1163733","889","1290697","0.45"
"2025-10-05T17:45:32.954Z","Included","auto","No","3684","83328","612513","705","700230","0.27"
"2025-10-05T17:34:48.668Z","Included","auto","No","135677","0","3415708","8802","3560187","1.08"
"2025-10-05T16:48:10.438Z","Included","auto","No","11232","15286","1098698","3592","1128808","0.33"
"2025-10-05T16:45:49.009Z","Included","auto","No","1334","13624","74449","459","89866","0.04"
"2025-10-05T16:44:49.486Z","Included","auto","No","1684","12076","93183","617","107560","0.04"
"2025-10-05T16:43:48.207Z","Included","auto","No","2019","9690","149123","704","161536","0.06"
"2025-10-05T16:41:57.490Z","Included","auto","No","2059","8290","97730","811","108890","0.04"
"2025-10-05T16:36:35.839Z","Included","auto","No","11202","0","25388","228","36818","0.02"
"2025-10-05T16:29:27.995Z","Included","auto","No","6572","0","127129","1117","134818","0.05"
"2025-10-05T16:27:48.526Z","Errored, Not Charged","auto","No","0","0","0","0","0","0.00"
"2025-10-05T16:16:52.090Z","Included","auto","No","18663","0","373056","2736","394455","0.13"
"2025-10-05T15:40:57.080Z","Included","auto","No","19567","0","240913","1204","261684","0.09"
"2025-10-05T15:30:03.783Z","Included","auto","No","12372","90628","1453857","2624","1559481","0.51"
"2025-10-05T15:22:48.080Z","Included","auto","No","46267","84897","1067909","6534","1205607","0.47"
"2025-10-05T15:16:46.570Z","Included","auto","No","5600","33315","518364","6244","563523","0.22"
"2025-10-05T15:13:57.096Z","Included","auto","No","32546","29126","157597","4144","223413","0.14"
"2025-10-04T19:21:16.891Z","Included","auto","No","27749","0","178689","10108","216546","0.14"
"2025-10-04T19:05:08.841Z","Included","auto","No","3361","37897","343322","1620","386200","0.15"
"2025-10-04T18:52:08.612Z","Included","auto","No","4180","31377","176351","984","212892","0.09"
"2025-10-04T18:35:49.278Z","Included","auto","No","30934","0","786483","5660","823077","0.27"
"2025-10-04T18:23:02.533Z","Included","auto","No","34168","0","293578","3432","331178","0.14"
"2025-10-04T18:13:19.905Z","Included","auto","No","70938","0","2090022","4042","2165002","0.64"
"2025-10-04T17:49:16.445Z","Included","auto","No","42662","50361","204442","577","298042","0.17"
"2025-10-04T17:45:42.403Z","Included","auto","No","88224","92951","735725","4242","921142","0.44"
"2025-10-04T17:34:43.018Z","Included","auto","No","6313","87378","1016030","2332","1112053","0.39"
"2025-10-04T17:29:36.937Z","Included","auto","No","3410","84804","542035","1246","631495","0.25"
"2025-10-04T17:26:12.198Z","Included","auto","No","3932","81622","841735","1428","928717","0.33"
"2025-10-04T17:24:31.319Z","Included","auto","No","2880","79500","405285","1180","488845","0.21"
"2025-10-04T17:21:07.696Z","Included","auto","No","4481","76200","390159","1615","472455","0.21"
"2025-10-04T17:17:23.105Z","Included","auto","No","93087","67389","1184941","3579","1348996","0.52"
"2025-10-04T17:13:02.579Z","Included","auto","No","4002","65348","509947","1226","580523","0.22"
"2025-10-04T17:10:16.887Z","Included","auto","No","79745","55283","619907","3207","758142","0.34"
"2025-10-04T16:30:04.772Z","Included","auto","No","97453","90887","1100240","6475","1295055","0.55"
"2025-10-04T16:12:25.612Z","Included","auto","No","117797","75698","852907","8495","1054897","0.51"
"2025-10-04T16:07:39.719Z","Included","auto","No","7814","61490","521503","6299","597106","0.25"
"2025-10-04T16:06:21.023Z","Included","auto","No","2656","58838","330630","627","392751","0.16"
"2025-10-04T16:04:11.128Z","Included","auto","No","4786","57256","238405","857","301304","0.14"
"2025-10-04T15:56:12.284Z","Included","auto","No","12984","40891","2230237","4338","2288450","0.65"
"2025-10-04T15:40:06.939Z","Included","auto","No","30691","26557","1295981","18086","1371315","0.50"
"2025-10-04T15:35:50.272Z","Included","auto","No","9305","15199","139964","1865","166333","0.08"
"2025-10-04T15:32:31.171Z","Included","auto","No","11780","0","104537","1646","117963","0.05"
"2025-10-04T15:25:20.282Z","Included","auto","No","1466","44361","150730","483","197040","0.10"
"2025-10-04T15:21:51.476Z","Included","auto","No","1398","43065","146678","450","191591","0.09"
"2025-10-04T15:13:52.371Z","Included","auto","No","45698","0","638267","4210","688175","0.24"
"2025-10-04T13:25:05.741Z","Included","gemini-2.5-pro","No","0","191001","3875","186","195062","0.14"
"2025-10-04T13:23:22.721Z","Included","gemini-2.5-pro","No","0","92186","100725","870","193781","0.06"
"2025-10-04T13:21:48.176Z","Included","gemini-2.5-pro","No","0","90169","100683","1501","192353","0.06"
"2025-10-04T13:20:45.867Z","Included","gemini-2.5-pro","No","0","95001","193553","166","288720","0.08"
"2025-10-04T13:19:02.422Z","Included","gemini-2.5-pro","No","0","185439","100547","109","286095","0.17"
"2025-10-04T13:16:46.427Z","Included","gemini-2.5-pro","No","0","181000","3869","564","185433","0.14"
"2025-10-04T13:11:35.742Z","Included","gemini-2.5-pro","No","0","84667","0","7","84674","0.01"
"2025-10-04T13:09:26.275Z","Included","gemini-2.5-pro","No","0","94923","184203","1362","280488","0.09"
"2025-10-04T13:08:47.783Z","Included","gemini-2.5-pro","No","0","107227","162349","132","269708","0.10"
"2025-10-04T13:06:46.879Z","Included","gemini-2.5-pro","No","0","85232","161673","210","247115","0.08"
"2025-10-04T13:04:35.615Z","Included","gemini-2.5-pro","No","0","153192","0","311","153503","0.12"
"2025-10-04T13:02:32.529Z","Included","gemini-2.5-pro","No","0","76242","159971","411","236624","0.07"
"2025-10-04T12:59:16.035Z","Included","gemini-2.5-pro","No","0","151340","80513","500","232353","0.14"
"2025-10-04T12:55:05.333Z","Included","gemini-2.5-pro","No","0","68202","76543","799","145544","0.04"
"2025-10-04T12:53:16.649Z","Included","gemini-2.5-pro","No","0","149934","72750","545","223229","0.14"
"2025-10-04T12:48:13.469Z","Included","gemini-2.5-pro","No","0","64588","0","477","65065","0.01"
"2025-10-04T12:46:54.822Z","Included","gemini-2.5-pro","No","0","71215","144617","549","216381","0.07"
"2025-10-04T12:44:54.288Z","Included","gemini-2.5-pro","No","0","69075","68924","334","138333","0.04"
"2025-10-04T12:42:49.394Z","Included","gemini-2.5-pro","No","0","72024","140441","1132","213597","0.07"
"2025-10-04T12:41:35.096Z","Included","gemini-2.5-pro","No","0","69721","137725","480","207926","0.07"
"2025-10-04T12:40:18.444Z","Included","gemini-2.5-pro","No","0","143957","205805","564","350326","0.18"
"2025-10-04T12:38:55.906Z","Included","gemini-2.5-pro","No","0","68571","133680","418","202669","0.07"
"2025-10-04T12:34:26.338Z","Included","gemini-2.5-pro","No","0","129739","68452","631","198822","0.12"
"2025-10-04T12:31:03.000Z","Included","gemini-2.5-pro","No","0","198862","64635","699","264196","0.21"
"2025-10-04T12:27:28.203Z","Included","gemini-2.5-pro","No","0","8301","115737","544","124582","0.03"
"2025-10-04T12:25:36.657Z","Included","gemini-2.5-pro","No","0","73360","179613","663","253636","0.09"
"2025-10-04T12:23:42.420Z","Included","gemini-2.5-pro","No","0","185858","60294","1020","247172","0.20"
"2025-10-04T12:19:17.253Z","Included","gemini-2.5-pro","No","0","175890","0","1056","176946","0.17"
"2025-10-04T12:12:41.918Z","Included","gemini-2.5-pro","No","0","116831","102574","1839","221244","0.14"
"2025-10-04T12:08:49.135Z","Included","gemini-2.5-pro","No","0","148912","3805","902","153619","0.15"
"2025-10-04T12:01:15.548Z","Included","gemini-2.5-pro","No","0","92895","3802","605","97302","0.07"
"2025-10-04T11:56:01.529Z","Included","gemini-2.5-pro","No","0","93820","0","1065","94885","0.08"
"2025-10-04T11:50:13.495Z","Included","gemini-2.5-pro","No","0","46624","45505","1834","93963","0.04"
"2025-10-04T11:45:43.652Z","Included","gemini-2.5-pro","No","0","43245","45401","689","89335","0.03"
"2025-10-04T11:41:35.251Z","Included","gemini-2.5-pro","No","0","93812","90048","844","184704","0.11"
"2025-10-04T11:38:54.650Z","Included","gemini-2.5-pro","No","0","83676","48877","609","133162","0.08"
"2025-10-04T11:29:29.425Z","Included","gemini-2.5-pro","No","0","90263","88715","685","179663","0.11"
"2025-10-04T11:20:59.593Z","Errored, Not Charged","gemini-2.5-pro","No","0","36867","0","258","37125","0.01"
"2025-10-04T09:10:30.741Z","Included","gemini-2.5-pro","No","0","79403","0","642","80045","0.07"
"2025-10-04T09:01:50.358Z","Included","gemini-2.5-pro","No","0","77786","0","736","78522","0.07"
"2025-10-04T08:58:59.511Z","Included","gemini-2.5-pro","No","0","35954","37509","777","74240","0.03"
"2025-10-04T08:57:08.363Z","Included","gemini-2.5-pro","No","0","38019","70976","809","109804","0.04"
"2025-10-04T08:55:40.669Z","Included","gemini-2.5-pro","No","0","68128","0","370","68498","0.06"
"2025-10-04T08:52:43.035Z","Included","gemini-2.5-pro","No","0","66615","0","698","67313","0.06"
"2025-10-04T07:22:16.432Z","Included","gemini-2.5-pro","No","0","64020","0","655","64675","0.06"
"2025-10-04T07:18:14.893Z","Included","gemini-2.5-pro","No","0","58526","3711","689","62926","0.05"
"2025-10-04T06:26:32.968Z","Included","gemini-2.5-pro","No","0","60396","0","1207","61603","0.06"
"2025-10-04T06:13:56.277Z","Included","gemini-2.5-pro","No","0","57993","0","2076","60069","0.06"
"2025-10-04T06:05:42.711Z","Included","gemini-2.5-pro","No","0","28539","27988","1641","58168","0.03"
"2025-10-04T06:00:43.465Z","Included","gemini-2.5-pro","No","0","53316","0","1001","54317","0.05"
"2025-10-04T05:53:09.602Z","Included","gemini-2.5-pro","No","0","46970","0","1342","48312","0.05"
"2025-10-04T05:46:59.696Z","Included","gemini-2.5-pro","No","0","43218","0","487","43705","0.04"
"2025-10-04T05:41:30.648Z","Included","gemini-2.5-pro","No","0","22599","16732","841","40172","0.02"
"2025-10-04T05:37:52.111Z","Included","gemini-2.5-pro","No","0","41700","71343","1569","114612","0.08"
"2025-10-04T05:33:22.177Z","Errored, Not Charged","gemini-2.5-pro","No","0","10313","0","5","10318","0.002"
"2025-10-04T05:32:09.572Z","Included","gemini-2.5-pro","No","0","15033","0","705","15738","0.03"
"2025-10-03T19:02:30.676Z","Included","auto","No","10653","18323","19275","86","48337","0.04"
"2025-10-03T18:59:14.398Z","Included","auto","No","22197","0","652183","3642","678022","0.21"
"2025-10-03T14:36:06.912Z","Included","auto","No","42068","32101","248101","1426","323696","0.16"
"2025-10-03T14:22:02.902Z","Included","auto","No","38126","23523","549172","3911","614732","0.24"
"2025-10-03T14:07:09.727Z","Included","auto","No","155737","191391","672540","11422","1031090","0.67"
"2025-10-03T13:44:52.152Z","Included","auto","No","10156","0","48111","775","59042","0.03"
"2025-10-03T13:38:57.490Z","Included","auto","No","5325","92614","1036603","2222","1136764","0.39"
"2025-10-03T13:33:05.157Z","Included","auto","No","8922","83702","862378","1419","956421","0.34"
"2025-10-03T13:28:22.567Z","Included","auto","No","96304","76081","798157","4280","974822","0.44"
"2025-10-03T13:12:22.693Z","Included","auto","No","8006","69201","797692","3601","878500","0.32"
"2025-10-03T13:07:10.619Z","Included","auto","No","78134","57741","1261824","5691","1403390","0.52"
"2025-10-03T12:59:24.906Z","Included","auto","No","8066","51841","607357","3500","670764","0.25"
"2025-10-03T12:55:24.230Z","Included","auto","No","3212","48816","183990","1505","237523","0.12"
"2025-10-03T12:50:32.807Z","Included","auto","No","53064","45593","241997","2073","342727","0.20"
"2025-10-03T10:08:19.189Z","Included","auto","No","51424","41356","162727","1043","256550","0.16"
"2025-10-03T09:52:45.605Z","Included","auto","No","42059","34972","468584","6435","552050","0.25"
"2025-10-03T09:46:44.376Z","Included","auto","No","40445","99367","508572","4506","652890","0.33"
"2025-10-03T09:36:20.366Z","Included","auto","No","110679","95364","699101","4658","909802","0.46"
"2025-10-03T09:34:14.522Z","Included","auto","No","3090","92458","453385","1317","550250","0.24"
"2025-10-03T09:32:27.622Z","Included","auto","No","104873","90189","340211","1322","536595","0.34"
"2025-10-03T08:50:05.834Z","Included","auto","No","102130","83514","962636","4710","1152990","0.50"
"2025-10-03T08:10:35.233Z","Included","auto","No","31963","0","701018","4964","737945","0.24"
"2025-10-03T07:56:35.142Z","Included","auto","No","11889","74669","1329374","5654","1421586","0.47"
"2025-10-03T07:54:02.114Z","Included","auto","No","81418","64633","927184","2714","1075949","0.43"
"2025-10-03T06:03:22.779Z","Included","auto","No","7761","57685","664390","2871","732707","0.27"
"2025-10-03T05:58:44.714Z","Included","auto","No","900","56689","69484","280","127353","0.09"
"2025-10-03T05:56:32.366Z","Included","auto","No","2540","54999","204763","621","262923","0.13"
"2025-10-03T05:50:21.646Z","Included","auto","No","61473","53393","207341","1561","323768","0.20"
"2025-10-03T05:45:38.658Z","Included","auto","No","7741","47278","700693","2767","758479","0.26"
"2025-10-03T05:34:30.929Z","Included","auto","No","2045","45088","173641","777","221551","0.11"
"2025-10-03T05:31:24.436Z","Included","auto","No","49970","42470","230434","1179","324053","0.18"
"2025-10-03T05:26:46.145Z","Included","auto","No","45665","41631","268521","779","356596","0.18"
"2025-10-03T05:09:43.861Z","Included","auto","No","7838","35931","422147","3372","469288","0.18"
"2025-10-03T05:02:11.593Z","Included","auto","No","712","34936","42260","254","78162","0.06"
"2025-10-03T04:59:24.084Z","Included","auto","No","31422","0","431276","4241","466939","0.17"
"2025-10-03T04:51:28.472Z","Included","auto","No","2060","0","186010","910","188980","0.05"
"2025-10-03T04:47:32.051Z","Included","auto","No","22491","0","499433","3816","525740","0.18"
"2025-10-03T04:35:39.648Z","Included","auto","No","9114","0","68281","969","78364","0.03"
"2025-10-02T19:36:11.975Z","Included","auto","No","8689","0","122947","1453","133089","0.05"
"2025-10-02T19:23:44.588Z","Included","auto","No","56650","47310","70219","977","175156","0.15"
"2025-10-02T19:10:59.173Z","Included","auto","No","2768","44996","242362","909","291035","0.13"
"2025-10-02T19:05:16.871Z","Included","auto","No","2821","42585","172343","861","218610","0.11"
"2025-10-02T18:58:57.615Z","Included","auto","No","49339","38572","499219","2818","589948","0.25"
"2025-10-02T18:48:53.253Z","Included","auto","No","4510","35002","240394","1249","281155","0.12"
"2025-10-02T18:45:32.515Z","Included","auto","No","3090","31644","132540","462","167736","0.08"
"2025-10-02T18:38:17.655Z","Included","auto","No","35298","0","1041315","8058","1084671","0.35"
"2025-10-02T16:06:04.398Z","Included","auto","No","4024","2577","167845","1268","175714","0.06"
"2025-10-02T16:05:09.735Z","Included","auto","No","6074","0","20311","192","26577","0.01"
"2025-10-02T15:55:26.660Z","Included","auto","No","21522","15333","341471","1567","379893","0.14"
"2025-10-02T15:50:47.280Z","Included","auto","No","19248","0","159095","1341","179684","0.07"
"2025-10-02T13:38:30.889Z","Included","auto","No","101966","103487","116213","587","322253","0.29"
"2025-10-02T13:33:55.522Z","Included","auto","No","1222","102648","106923","517","211310","0.16"
"2025-10-02T13:24:35.164Z","Included","auto","No","1083","101275","105841","469","208668","0.16"
"2025-10-02T13:15:17.434Z","Included","auto","No","22392","100098","83450","632","206572","0.18"
"2025-10-02T13:06:48.906Z","Included","auto","No","7338","77927","76113","1091","162469","0.13"
"2025-10-02T13:01:21.693Z","Included","auto","No","4995","65082","293356","1624","365057","0.17"
"2025-10-02T12:55:33.579Z","Errored, Not Charged","auto","No","1158","0","69965","447","71570","0.02"
"2025-10-02T12:45:05.588Z","Included","auto","No","5401","58968","130256","790","195415","0.12"
"2025-10-02T12:41:22.624Z","Included","auto","No","1159","57779","63408","559","122905","0.09"
"2025-10-02T12:34:50.950Z","Included","auto","No","56132","56578","7277","1622","121609","0.15"
"2025-10-02T09:13:06.494Z","Included","auto","No","3434","55446","58953","602","118435","0.09"
"2025-10-02T08:58:45.943Z","Included","auto","No","2763","53500","57775","1874","115912","0.10"
"2025-10-02T08:49:25.999Z","Included","auto","No","5438","46517","272781","3033","327769","0.15"
"2025-10-02T08:44:03.943Z","Included","auto","No","2709","44885","49634","870","98098","0.08"
"2025-10-02T08:31:00.797Z","Included","auto","No","2578","42103","47057","910","92648","0.07"
"2025-10-02T08:26:18.425Z","Included","auto","No","41141","40882","7121","918","90062","0.11"
"2025-10-02T08:17:25.336Z","Included","auto","No","39785","39386","7273","1159","87603","0.11"
"2025-10-02T08:16:04.061Z","Included","grok-4-0709","No","0","0","0","0","0","0.00"
"2025-10-02T07:43:45.858Z","Included","grok-4-0709","No","0","76575","3273","894","80742","0.14"
"2025-10-02T07:40:45.745Z","Included","grok-4-0709","No","0","74496","3273","839","78608","0.13"
"2025-10-02T07:29:26.581Z","Included","grok-4-0709","No","0","37131","37684","1258","76073","0.06"
"2025-10-02T07:28:18.838Z","Included","grok-4-0709","No","0","67334","40962","88","108384","0.14"
"2025-10-02T07:23:01.186Z","Included","grok-4-0709","No","0","64395","3273","982","68650","0.12"
"2025-10-02T07:06:30.094Z","Included","grok-4-0709","No","0","29176","34653","2461","66290","0.05"
"2025-10-02T07:05:36.684Z","Errored, Not Charged","grok-4-0709","No","0","0","0","0","0","0.00"
"2025-10-02T06:54:51.620Z","Included","grok-4-0709","No","0","28821","31951","1165","61937","0.05"
"2025-10-02T06:49:11.257Z","Included","grok-4-0709","No","0","48984","9025","1123","59132","0.10"
"2025-10-02T06:33:43.651Z","Included","grok-4-0709","No","0","26043","29785","775","56603","0.04"
"2025-10-02T06:29:19.715Z","Included","grok-4-0709","No","0","25161","28277","974","54412","0.04"
"2025-10-02T06:22:49.450Z","Included","grok-4-0709","No","0","50841","29115","167","80123","0.11"
"2025-10-02T06:17:08.228Z","Included","grok-4-0709","No","0","44574","29473","1175","75222","0.12"
"2025-10-02T06:08:58.113Z","Included","grok-4-0709","No","0","19071","0","8","19079","0.003"
"2025-10-02T05:58:49.406Z","Included","grok-4-0709","No","0","41365","833","1137","43335","0.08"
"2025-10-02T05:41:41.098Z","Included","grok-4-0709","No","0","37273","78606","4023","119902","0.23"
"2025-10-02T05:25:54.432Z","Included","auto","No","26599","26146","7273","1665","61683","0.08"
"2025-10-01T13:58:44.323Z","Included","auto","No","2706","18225","321572","1590","344093","0.12"
"2025-10-01T13:53:44.080Z","Included","auto","No","18008","16591","203633","1116","239348","0.10"
"2025-10-01T13:46:29.431Z","Included","auto","No","16324","105433","375231","1780","498768","0.26"
"2025-10-01T13:38:54.979Z","Included","auto","No","3474","102652","1298638","1558","1406322","0.47"
"2025-10-01T13:36:03.400Z","Included","auto","No","19099","82384","387221","930","489634","0.23"
"2025-10-01T13:33:14.299Z","Included","auto","No","1971","80987","604150","1202","688310","0.26"
"2025-10-01T13:29:24.327Z","Included","auto","No","1944","79252","422005","935","504136","0.21"
"2025-10-01T13:24:53.969Z","Included","auto","No","3532","78023","493190","931","575676","0.23"
"2025-10-01T13:20:36.147Z","Included","auto","No","3458","72115","388363","705","464641","0.20"
"2025-10-01T13:17:34.471Z","Included","auto","No","1814","71113","377994","901","451822","0.19"
"2025-10-01T13:09:15.646Z","Included","auto","No","391","70487","74308","533","145719","0.11"
"2025-10-01T13:04:29.183Z","Included","auto","No","67036","67885","300497","905","436323","0.25"
"2025-10-01T12:57:44.261Z","Included","auto","No","23858","70543","576153","3546","674100","0.28"
"2025-10-01T12:54:29.096Z","Included","auto","No","7633","53708","412514","2180","476035","0.19"
"2025-10-01T12:47:19.210Z","Included","auto","No","57407","50830","204985","2656","315878","0.20"
"2025-10-01T12:35:28.301Z","Included","auto","No","1508","46069","60202","1482","109261","0.08"
"2025-10-01T12:30:58.869Z","Included","auto","No","102645","45665","19486","712","168508","0.19"
"2025-10-01T12:20:01.943Z","Included","auto","No","52868","52523","798679","7736","911806","0.38"
"2025-10-01T12:13:53.986Z","Included","auto","No","30463","26782","9743","1055","68043","0.08"
"2025-10-01T12:10:47.314Z","Included","auto","No","29909","27453","47518","1168","106048","0.09"
"2025-10-01T12:06:13.051Z","Included","auto","No","27781","25828","294456","4793","352858","0.17"
"2025-10-01T11:54:20.802Z","Included","auto","No","9799","10438","9743","1639","31619","0.04"
"2025-10-01T09:03:13.889Z","Included","auto","No","10825","7057","76524","3045","97451","0.06"
"2025-10-01T06:55:44.516Z","Included","auto","No","29364","68324","242395","3910","343993","0.21"
"2025-10-01T06:44:57.584Z","Included","auto","No","23949","86228","574168","8765","693110","0.33"
"2025-09-30T19:34:08.148Z","Included","auto","No","92686","35280","2409529","10483","2547978","0.83"
"2025-09-30T19:24:36.311Z","Included","auto","No","68887","59894","755744","9969","894494","0.41"
"2025-09-30T19:16:03.158Z","Included","auto","No","23076","14782","399827","10092","447777","0.21"
"2025-09-30T19:12:04.890Z","Included","auto","No","41713","37513","383147","6585","468958","0.23"
"2025-09-30T19:02:52.081Z","Included","auto","No","3489","32819","137829","7016","181153","0.12"
"2025-09-30T19:01:28.593Z","Included","auto","No","7472","21305","25218","1165","55160","0.05"
"2025-09-30T18:59:51.235Z","Included","auto","No","16107","21091","35403","2467","75068","0.07"
"2025-09-30T18:54:18.710Z","Included","auto","No","1726","11773","21820","2189","37508","0.04"
"2025-09-30T18:34:42.668Z","Included","auto","No","965","101410","136726","1055","240156","0.17"
"2025-09-30T18:29:54.178Z","Included","auto","No","5528","98940","543295","1076","648839","0.27"
"2025-09-30T18:26:07.852Z","Included","auto","No","125150","98586","411804","3038","638578","0.40"
"2025-09-30T18:06:16.767Z","Included","auto","No","38743","117962","5263965","18445","5439115","1.62"
"2025-09-30T18:06:09.423Z","Included","auto","No","0","70356","0","7","70363","0.09"
"2025-09-30T17:46:33.380Z","Included","auto","No","89743","83011","3112046","17248","3302048","1.10"
"2025-09-30T17:35:36.209Z","Included","auto","No","10110","39770","91011","2089","142980","0.10"
"2025-09-30T16:35:54.824Z","Included","auto","No","50717","100964","675576","11451","838708","0.43"
"2025-09-30T12:13:42.378Z","Included","auto","No","28573","27111","62649","1147","119480","0.09"
"2025-09-30T07:12:01.858Z","Included","auto","No","1733","13568","21875","1188","38364","0.03"
"2025-09-30T06:38:07.984Z","Included","auto","No","7092","11839","105413","2314","126658","0.06"
"2025-09-30T06:35:13.098Z","Included","auto","No","10100","9302","84389","2384","106175","0.06"
"2025-09-30T06:29:07.029Z","Included","auto","No","7595","5332","31399","1602","45928","0.03"
"2025-09-29T14:00:00.977Z","Included","auto","No","89643","46089","1137409","1930","1275071","0.47"
"2025-09-29T13:47:37.053Z","Included","auto","No","725","45420","104800","415","151360","0.09"
"2025-09-29T13:41:26.434Z","Included","auto","No","46799","100334","1059804","2075","1209012","0.46"
"2025-09-29T13:40:03.934Z","Included","auto","No","16470","83745","371033","555","471803","0.22"
"2025-09-29T13:36:57.250Z","Included","auto","No","32872","50782","738145","1516","823315","0.30"
"2025-09-29T13:33:19.014Z","Included","auto","No","31488","19815","541279","1683","594265","0.21"
"2025-09-29T13:32:46.464Z","Included","auto","No","452","19180","54186","434","74252","0.04"
"2025-09-29T13:30:38.377Z","Included","auto","No","2038","18620","78225","260","99143","0.05"
"2025-09-29T13:17:40.706Z","Included","auto","No","17896","13024","121627","1894","154441","0.08"
"2025-09-29T13:01:24.751Z","Included","auto","No","1539","11261","35700","520","49020","0.03"
"2025-09-29T12:54:12.044Z","Included","auto","No","5639","5980","180420","1502","193541","0.07"
"2025-09-29T12:47:17.848Z","Included","auto","No","4214","0","78563","752","83529","0.03"
"2025-09-29T12:33:41.042Z","Included","auto","No","7702","84755","1146037","3550","1242044","0.42"
"2025-09-29T12:29:13.046Z","Included","auto","No","2522","83144","600283","1463","687412","0.27"
"2025-09-29T12:26:26.664Z","Included","auto","No","4018","81322","385678","2504","473522","0.22"
"2025-09-29T12:10:56.124Z","Included","auto","No","13518","70378","2921012","5054","3009962","0.87"
"2025-09-29T12:02:22.029Z","Included","auto","No","74240","44053","1083848","1550","1203691","0.43"
"2025-09-29T09:08:44.163Z","Included","auto","No","33626","28610","47264","337","109837","0.09"
"2025-09-29T07:26:36.755Z","Included","auto","No","9947","20704","474402","3749","508802","0.18"
"2025-09-29T07:17:19.181Z","Included","auto","No","21874","0","188489","5165","215528","0.11"
"2025-09-29T06:48:22.288Z","Included","auto","No","12782","10681","57133","1693","82289","0.05"
"2025-09-29T06:29:41.856Z","Included","auto","No","7979","0","131266","595","139840","0.05"
"2025-09-29T05:22:37.214Z","Included","auto","No","6943","39013","1288304","2773","1337033","0.40"
"2025-09-29T05:19:34.219Z","Included","auto","No","5097","33903","590329","1333","630662","0.20"
"2025-09-29T05:17:41.095Z","Included","auto","No","2871","31198","283677","1248","318994","0.12"
"2025-09-29T05:17:23.951Z","Included","auto","No","644","31374","39321","99","71438","0.05"
"2025-09-29T05:15:22.059Z","Included","auto","No","2978","31387","485033","982","520380","0.17"
"2025-09-29T05:10:50.452Z","Included","auto","No","12815","20698","536220","5711","575444","0.21"
"2025-09-29T05:09:02.059Z","Included","auto","No","37428","2839","228065","368","268700","0.11"
"2025-09-29T04:59:20.764Z","Included","grok-code-fast-1","No","0","306251","6656","288","313195","0.05"
"2025-09-28T18:05:55.766Z","Included","auto","No","3307","37093","727177","1294","768871","0.24"
"2025-09-28T18:04:37.660Z","Errored, Not Charged","auto","No","0","3047","34339","3","37389","0.01"
"2025-09-28T18:03:55.434Z","Included","auto","No","2621","34856","226807","712","264996","0.11"
"2025-09-28T17:53:40.108Z","Included","auto","No","14228","22088","1407508","4032","1447856","0.42"
"2025-09-28T17:51:04.980Z","Included","auto","No","23002","18453","403707","1226","446388","0.16"
"2025-09-28T16:57:33.809Z","Included","auto","No","19043","310729","59018","3691","392481","0.45"
"2025-09-28T16:43:34.609Z","Errored, Not Charged","auto","No","0","446","113137","8","113591","0.03"
"2025-09-28T16:41:12.037Z","Errored, Not Charged","auto","No","0","446","113137","74","113657","0.03"
"2025-09-28T16:38:54.256Z","Errored, Not Charged","auto","No","0","113583","0","8","113591","0.14"
"2025-09-28T16:32:29.219Z","Errored, Not Charged","auto","No","107124","100907","685264","2831","896126","0.45"
"2025-09-28T16:24:02.471Z","Included","auto","No","11212","89690","918032","792","1019726","0.36"
"2025-09-28T16:18:35.889Z","Included","auto","No","20782","82545","1215119","3201","1321647","0.45"
"2025-09-28T16:06:22.940Z","Included","auto","No","119204","69038","4229744","6624","4424610","1.33"
"2025-09-28T16:02:12.756Z","Included","auto","No","17801","67171","127974","389","213335","0.14"
"2025-09-28T15:49:51.131Z","Errored, Not Charged","auto","No","64592","85321","1670755","3805","1824473","0.63"
"2025-09-28T15:47:13.552Z","Errored, Not Charged","auto","No","0","926","84395","26","85347","0.02"
"2025-09-28T15:44:49.167Z","Errored, Not Charged","auto","No","0","85321","0","7","85328","0.11"
"2025-09-28T15:42:08.756Z","Errored, Not Charged","auto","No","0","85720","0","280","86000","0.11"
"2025-09-28T15:34:07.424Z","Included","auto","No","24787","58665","2266712","2167","2352331","0.68"
"2025-09-28T15:31:20.632Z","Included","auto","No","86295","55255","654022","600","796172","0.34"
"2025-09-28T14:12:01.526Z","Included","auto","No","4820","52257","1138529","2393","1197999","0.37"
"2025-09-28T14:06:06.306Z","Included","auto","No","77698","42641","1782582","10161","1913082","0.66"
"2025-09-28T14:01:18.089Z","Included","auto","No","1438","40991","64772","1331","108532","0.08"
"2025-09-28T13:56:58.849Z","Included","auto","No","25111","40781","765268","592","831752","0.28"
"2025-09-28T13:42:28.061Z","Included","auto","No","66005","88270","758415","39162","951852","0.62"
"2025-09-28T13:37:29.074Z","Included","auto","No","17507","53397","94278","225","165407","0.11"
"2025-09-28T13:33:30.511Z","Included","auto","No","6144","29088","908282","3085","946599","0.29"
"2025-09-28T13:20:07.685Z","Included","auto","No","15645","23878","1168833","12160","1220516","0.41"
"2025-09-28T13:10:41.598Z","Included","auto","No","7548","20905","752468","5586","786507","0.26"
"2025-09-28T13:05:25.448Z","Included","auto","No","57871","18851","490490","9252","576464","0.27"
"2025-09-28T09:08:40.272Z","Included","auto","No","84763","128984","978080","31304","1223131","0.70"
"2025-09-28T09:04:04.024Z","Errored, Not Charged","auto","No","12583","63223","1173830","13038","1262674","0.47"
"2025-09-28T08:56:42.870Z","Included","auto","No","9354","61878","862295","7346","940873","0.35"
"2025-09-28T08:52:18.746Z","Included","auto","No","20949","45851","2018700","9138","2094638","0.64"
"2025-09-28T08:33:07.467Z","Included","auto","No","18003","45420","176212","8931","248566","0.18"
"2025-09-28T08:23:42.195Z","Included","auto","No","56909","134134","1272434","15305","1478782","0.65"
"2025-09-28T08:11:28.499Z","Included","auto","No","107493","51459","2394170","3240","2556362","0.82"
"2025-09-28T07:49:13.073Z","Included","auto","No","6184","46936","714791","2892","770803","0.26"
"2025-09-28T07:40:42.095Z","Included","auto","No","9640","39783","500474","4016","553913","0.21"
"2025-09-28T07:28:32.474Z","Included","auto","No","13151","29939","839269","5536","887895","0.30"
"2025-09-28T07:23:00.298Z","Included","auto","No","13220","19358","413677","5656","451911","0.18"
"2025-09-28T07:15:41.049Z","Included","auto","No","5474","17902","330981","4279","358636","0.14"
"2025-09-28T07:04:32.028Z","Included","auto","No","9817","13836","460501","5335","489489","0.18"
"2025-09-28T06:59:39.039Z","Included","auto","No","18302","8593","364308","1569","392772","0.13"
"2025-09-28T06:06:06.839Z","Included","auto","No","3602","4078","204930","1322","213932","0.07"
"2025-09-28T05:59:05.534Z","Included","auto","No","9632","0","84278","7677","101587","0.08"
"2025-09-28T04:59:35.005Z","Included","grok-code-fast-1","No","0","8135","140864","1165","150164","0.01"
"2025-09-26T12:21:33.233Z","Included","auto","No","273","6031","16944","59","23307","0.01"
"2025-09-26T12:20:45.977Z","Included","auto","No","463","5755","16482","156","22856","0.01"
"2025-09-26T12:18:15.962Z","Included","auto","No","5955","0","54984","877","61816","0.03"
"2025-09-26T12:05:49.629Z","Included","auto","No","22727","0","476959","2629","502315","0.16"
"2025-09-26T11:34:26.557Z","Included","auto","No","6462","0","1398993","2604","1408059","0.37"
"2025-09-26T11:32:30.880Z","Errored, Not Charged","auto","No","52885","0","1121641","1739","1176265","0.36"
"2025-09-26T11:24:26.471Z","Included","auto","No","9189","14216","303678","2743","329826","0.12"
"2025-09-26T11:19:54.955Z","Included","auto","No","12527","0","317542","2417","332486","0.11"
"2025-09-26T11:13:30.274Z","Included","auto","No","6864","86677","1612469","3176","1709186","0.54"
"2025-09-26T11:06:29.630Z","Included","auto","No","104215","80838","1413365","3724","1602142","0.61"
"2025-09-26T07:14:43.055Z","Included","auto","No","96703","75310","1219063","3067","1394143","0.54"
"2025-09-26T07:03:45.693Z","Included","auto","No","90831","69025","1504864","3688","1668408","0.60"
"2025-09-26T06:55:46.258Z","Errored, Not Charged","auto","No","83980","63311","938983","3460","1089734","0.44"
"2025-09-26T06:48:03.995Z","Errored, Not Charged","auto","No","143025","0","881135","3465","1027625","0.42"
"2025-09-26T05:59:31.933Z","Included","auto","No","12713","49265","1090959","5474","1158411","0.38"
"2025-09-26T05:57:18.928Z","Included","auto","No","859","48832","61141","363","111195","0.08"
"2025-09-26T05:55:02.448Z","Included","auto","No","4506","45343","709447","1488","760784","0.25"
"2025-09-26T05:51:56.815Z","Included","auto","No","14225","36392","1030140","3312","1084069","0.34"
"2025-09-26T05:46:27.141Z","Included","auto","No","64233","0","531378","7851","603462","0.26"
"2025-09-26T05:28:34.858Z","Included","auto","No","7832","29876","510485","3756","551949","0.20"
"2025-09-26T05:17:06.327Z","Included","auto","No","10019","22758","544574","4288","581639","0.20"
"2025-09-26T05:12:56.515Z","Included","auto","No","8389","16230","260769","3246","288634","0.12"
"2025-09-26T05:03:39.629Z","Included","auto","No","18317","0","312725","5085","336127","0.13"
"2025-09-26T04:53:32.555Z","Errored, Not Charged","auto","No","5259","0","81250","632","87141","0.03"
"2025-09-26T04:52:13.933Z","Included","auto","No","1571","0","9799","482","11852","0.01"
"2025-09-26T04:48:13.212Z","Included","auto","No","17322","12143","56050","308","85823","0.05"
"2025-09-26T04:31:44.391Z","Included","auto","No","16785","11912","7276","77","36050","0.04"
"2025-09-25T14:26:49.035Z","Included","auto","No","4161","25898","220803","3032","253894","0.11"
"2025-09-25T14:23:43.318Z","Included","auto","No","824","24555","52546","1147","79072","0.05"
"2025-09-25T14:20:55.619Z","Included","auto","No","643","23639","51904","326","76512","0.05"
"2025-09-25T14:19:25.616Z","Included","auto","No","872","22981","51033","441","75327","0.05"
"2025-09-25T14:16:07.955Z","Included","auto","No","43925","22065","7109","637","73736","0.09"
"2025-09-25T10:53:55.271Z","Included","auto","No","42655","20748","7129","806","71338","0.09"
"2025-09-25T09:02:02.820Z","Included","auto","No","13438","27769","44597","848","86652","0.07"
"2025-09-25T08:54:45.893Z","Included","auto","No","17973","27388","39671","219","85251","0.07"
"2025-09-25T08:44:34.359Z","Included","auto","No","7146","12111","314187","4551","337995","0.13"
"2025-09-25T08:30:54.043Z","Included","auto","No","15512","341","462771","10717","489341","0.20"
"2025-09-25T08:21:29.980Z","Included","auto","No","828","3988","42257","136","47209","0.02"
"2025-09-25T08:08:51.474Z","Included","auto","No","11844","1343","218484","10646","242317","0.13"
"2025-09-25T08:04:33.411Z","Errored, Not Charged","auto","No","1764","0","47802","10921","60487","0.08"
"2025-09-25T05:14:31.464Z","Included","auto","No","1857","6086","99234","1339","108516","0.04"
"2025-09-25T05:08:27.326Z","Included","auto","No","2136","5513","33914","2175","43738","0.03"
"2025-09-25T05:00:22.821Z","Included","auto","No","3604","2277","178096","1210","185187","0.06"
"2025-09-25T04:48:05.898Z","Included","auto","No","5963","0","32270","406","38639","0.02"
"2025-09-24T20:56:54.861Z","Included","gemini-2.5-pro","No","0","3582","134828","2631","141041","0.07"
"2025-09-24T20:54:57.799Z","Included","gemini-2.5-pro","No","0","133511","130561","1747","265819","0.08"
"2025-09-24T20:52:18.527Z","Included","gemini-2.5-pro","No","0","122595","130948","930","254473","0.07"
"2025-09-24T20:50:10.570Z","Included","gemini-2.5-pro","No","0","251882","0","1124","253006","0.19"
"2025-09-24T20:40:00.176Z","Included","gemini-2.5-pro","No","0","123180","126715","619","250514","0.07"
"2025-09-24T20:38:10.118Z","Included","gemini-2.5-pro","No","0","121267","126789","565","248621","0.07"
"2025-09-24T20:37:04.595Z","Included","gemini-2.5-pro","No","0","123803","122500","645","246948","0.07"
"2025-09-24T20:34:23.154Z","Included","gemini-2.5-pro","No","0","254665","117841","1015","373521","0.24"
"2025-09-24T20:26:18.265Z","Included","gemini-2.5-pro","No","0","361364","570668","2638","934670","0.54"
"2025-09-24T20:20:21.248Z","Included","gemini-2.5-pro","No","0","306181","436458","1361","744000","0.43"
"2025-09-24T20:18:26.390Z","Included","gemini-2.5-pro","No","0","189096","8766","1627","199489","0.15"
"2025-09-24T20:13:51.574Z","Included","gemini-2.5-pro","No","0","202502","399258","1567","603327","0.29"
"2025-09-24T20:12:12.210Z","Included","gemini-2.5-pro","No","0","388493","4361","681","393535","0.39"
"2025-09-24T20:07:54.290Z","Included","gemini-2.5-pro","No","0","188076","0","492","188568","0.14"
"2025-09-24T20:05:23.948Z","Included","gemini-2.5-pro","No","0","186047","0","891","186938","0.14"
"2025-09-24T20:00:18.445Z","Included","gemini-2.5-pro","No","0","174130","8847","893","183870","0.13"
"2025-09-24T19:52:26.126Z","Included","gemini-2.5-pro","No","0","290760","278733","1192","570685","0.37"
"2025-09-24T19:32:20.170Z","Included","gemini-2.5-pro","No","0","626977","675437","15722","1318136","0.83"
"2025-09-24T19:30:28.289Z","Included","gemini-2.5-pro","No","0","157968","3930","1588","163486","0.12"
"2025-09-24T19:17:52.685Z","Included","gemini-2.5-pro","No","0","78639","78490","518","157647","0.04"
"2025-09-24T19:14:38.102Z","Included","gemini-2.5-pro","No","0","75574","78438","1780","155792","0.05"
"2025-09-24T19:12:56.336Z","Included","gemini-2.5-pro","No","0","73525","78406","257","152188","0.04"
"2025-09-24T19:11:29.048Z","Included","gemini-2.5-pro","No","0","150582","0","932","151514","0.12"
"2025-09-24T19:07:44.157Z","Errored, Not Charged","gemini-2.5-pro","No","0","0","0","0","0","0.00"
"2025-09-24T19:04:42.428Z","Included","gemini-2.5-pro","No","0","73065","74420","1041","148526","0.05"
"2025-09-24T19:02:34.355Z","Included","gemini-2.5-pro","No","0","72596","74428","101","147125","0.04"
"2025-09-24T19:00:23.446Z","Included","gemini-2.5-pro","No","0","70655","74410","2302","147367","0.05"
"2025-09-24T18:58:20.741Z","Included","gemini-2.5-pro","No","0","68600","74398","927","143925","0.04"
"2025-09-24T18:54:20.038Z","Included","gemini-2.5-pro","No","0","70660","70469","1350","142479","0.05"
"2025-09-24T18:50:02.291Z","Included","gemini-2.5-pro","No","0","205151","7829","568","213548","0.19"
"2025-09-24T18:45:30.149Z","Included","gemini-2.5-pro","No","0","129175","7827","1516","138518","0.10"
"2025-09-24T18:44:18.275Z","Included","gemini-2.5-pro","No","0","135845","0","779","136624","0.10"
"2025-09-24T18:36:08.592Z","Included","gemini-2.5-pro","No","0","114424","50839","984","166247","0.12"
"2025-09-24T16:59:35.897Z","Included","gemini-2.5-pro","No","0","85857","7673","719","94249","0.07"
"2025-09-24T16:40:18.272Z","Included","gemini-2.5-pro","No","0","45337","46002","470","91809","0.03"
"2025-09-24T16:37:04.827Z","Included","gemini-2.5-pro","No","0","88804","0","576","89380","0.07"
"2025-09-24T16:22:05.241Z","Errored, Not Charged","gemini-2.5-pro","No","0","40001","7640","709","48350","0.06"
"2025-09-24T16:15:51.030Z","Included","gemini-2.5-pro","No","0","82014","0","1293","83307","0.07"
"2025-09-24T16:06:10.823Z","Included","gemini-2.5-pro","No","0","77127","46576","1185","124888","0.09"
"2025-09-24T16:02:24.513Z","Included","gemini-2.5-pro","No","0","66073","7581","1552","75206","0.06"
"2025-09-24T15:52:25.003Z","Included","gemini-2.5-pro","No","0","106710","45405","927","153042","0.12"
"2025-09-24T15:46:04.877Z","Included","gemini-2.5-pro","No","0","67257","0","923","68180","0.06"
"2025-09-24T15:43:16.958Z","Included","gemini-2.5-pro","No","0","84327","11194","786","96307","0.09"
"2025-09-24T14:53:02.522Z","Included","gemini-2.5-pro","No","0","58404","0","642","59046","0.05"
"2025-09-24T14:01:09.016Z","Included","gemini-2.5-pro","No","0","53794","0","658","54452","0.05"
"2025-09-24T13:54:32.486Z","Included","gemini-2.5-pro","No","0","45937","3710","845","50492","0.04"
"2025-09-24T13:51:58.015Z","Included","gemini-2.5-pro","No","0","36750","0","396","37146","0.03"
"2025-09-24T13:43:59.950Z","Included","gemini-2.5-pro","No","0","324374","6964","4300","335638","0.08"
"2025-09-24T13:36:44.387Z","Included","gemini-2.5-pro","No","0","2828","318366","1079","322273","0.07"
"2025-09-24T13:33:52.618Z","Included","gemini-2.5-pro","No","0","158173","322964","1669","482806","0.14"
"2025-09-24T13:24:33.565Z","Included","gemini-2.5-pro","No","0","312469","0","472","312941","0.23"
"2025-09-24T12:42:01.704Z","Included","gemini-2.5-pro","No","0","308337","0","260","308597","0.22"
"2025-09-24T12:32:56.679Z","Included","gemini-2.5-pro","No","0","297732","0","828","298560","0.22"
"2025-09-24T08:26:15.360Z","Included","gemini-2.5-pro","No","0","140832","149645","923","291400","0.08"
"2025-09-24T08:22:53.411Z","Included","gemini-2.5-pro","No","0","287936","0","860","288796","0.22"
"2025-09-24T08:10:10.019Z","Included","gemini-2.5-pro","No","0","140138","145471","845","286454","0.07"
"2025-09-24T08:06:23.558Z","Included","gemini-2.5-pro","No","0","282550","0","933","283483","0.21"
"2025-09-24T08:01:43.659Z","Included","gemini-2.5-pro","No","0","273793","0","1421","275214","0.21"
"2025-09-24T07:01:48.005Z","Included","gemini-2.5-pro","No","0","400528","140721","1015","542264","0.42"
"2025-09-23T18:51:05.342Z","Included","gemini-2.5-pro","No","0","256906","0","1712","258618","0.20"
"2025-09-23T18:45:39.648Z","Included","gemini-2.5-pro","No","0","255853","0","185","256038","0.19"
"2025-09-23T12:12:18.577Z","Included","gemini-2.5-pro","No","0","151732","102692","578","255002","0.09"
"2025-09-23T12:09:59.822Z","Included","gemini-2.5-pro","No","0","223068","102557","361","325986","0.21"
"2025-09-23T12:03:25.643Z","Included","gemini-2.5-pro","No","0","112608","179505","1054","293167","0.11"
"2025-09-23T11:59:12.435Z","Included","gemini-2.5-pro","No","0","269380","265065","1422","535867","0.35"
"2025-09-23T07:30:51.771Z","Included","gemini-2.5-pro","No","0","165609","0","267","165876","0.12"
"2025-09-23T07:21:13.433Z","Included","gemini-2.5-pro","No","0","109091","53951","1399","164441","0.12"
"2025-09-23T07:13:58.233Z","Included","gemini-2.5-pro","No","0","104659","49801","935","155395","0.10"
"2025-09-23T07:08:08.230Z","Included","gemini-2.5-pro","No","0","66704","46019","1243","113966","0.09"
"2025-09-23T06:59:18.045Z","Included","gemini-2.5-pro","No","0","24266","53074","942","78282","0.04"
"2025-09-23T06:58:18.428Z","Included","gemini-2.5-pro","No","0","15870","17643","408","33921","0.01"
"2025-09-23T06:57:31.415Z","Included","gemini-2.5-pro","No","0","31504","0","145","31649","0.03"
"2025-09-23T06:54:09.962Z","Included","gemini-2.5-pro","No","0","12545","17430","493","30468","0.01"
"2025-09-23T06:53:03.425Z","Included","gemini-2.5-pro","No","0","14351","13853","389","28593","0.01"
"2025-09-23T06:50:36.425Z","Included","gemini-2.5-pro","No","0","25997","0","661","26658","0.03"
"2025-09-23T06:45:29.755Z","Included","gemini-2.5-pro","No","0","26377","13192","661","40230","0.03"
"2025-09-23T06:35:53.450Z","Included","gemini-2.5-pro","No","0","12066","10111","245","22422","0.01"
"2025-09-23T06:32:46.407Z","Included","gemini-2.5-pro","No","0","31262","52781","1365","85408","0.06"
"2025-09-23T06:12:59.586Z","Included","gemini-2.5-pro","No","0","7926","6390","554","14870","0.01"
"2025-09-23T06:11:09.627Z","Included","gemini-2.5-pro","No","0","17348","39024","1075","57447","0.04"
"2025-09-22T15:54:04.788Z","Included","gemini-2.5-pro","No","0","154727","8311","437","163475","0.12"
"2025-09-22T15:52:14.377Z","Included","gemini-2.5-pro","No","0","173876","8313","616","182805","0.18"
"2025-09-22T15:51:37.314Z","Included","gemini-2.5-pro","No","0","44806","50068","218","95092","0.03"
"2025-09-22T15:48:55.893Z","Included","gemini-2.5-pro","No","0","86066","7699","386","94151","0.07"
"2025-09-22T15:47:47.571Z","Included","gemini-2.5-pro","No","0","134420","7658","411","142489","0.13"
"2025-09-22T14:31:45.177Z","Included","gemini-2.5-pro","No","0","79543","7651","559","87753","0.07"
"2025-09-22T14:18:25.546Z","Included","gemini-2.5-pro","No","0","42567","38159","206","80932","0.03"
"2025-09-22T14:14:14.211Z","Included","gemini-2.5-pro","No","0","149278","11300","870","161448","0.16"
"2025-09-22T14:05:30.609Z","Included","gemini-2.5-pro","No","0","98413","7306","654","106373","0.10"
"2025-09-22T14:02:55.324Z","Included","gemini-2.5-pro","No","0","63102","0","327","63429","0.05"
"2025-09-22T13:57:18.238Z","Included","gemini-2.5-pro","No","0","53141","7450","785","61376","0.05"
"2025-09-22T13:37:26.165Z","Included","gemini-2.5-pro","No","0","57989","0","1064","59053","0.05"
"2025-09-22T13:28:23.838Z","Included","gemini-2.5-pro","No","0","42667","7339","698","50704","0.04"
"2025-09-22T13:18:37.338Z","Included","gemini-2.5-pro","No","0","38232","0","372","38604","0.04"
"2025-09-22T13:08:22.485Z","Included","gemini-2.5-pro","No","0","27339","7095","655","35089","0.03"
"2025-09-22T12:43:38.083Z","Included","gemini-2.5-pro","No","0","28670","5841","5574","40085","0.10"
"2025-09-22T09:03:14.568Z","Included","gemini-2.5-pro","No","0","184926","7846","459","193231","0.14"
"2025-09-22T08:59:18.034Z","Included","gemini-2.5-pro","No","0","211929","484707","1547","698183","0.34"
"2025-09-22T08:56:53.556Z","Included","gemini-2.5-pro","No","0","282553","97597","892","381042","0.30"
"2025-09-22T08:41:32.488Z","Included","gemini-2.5-pro","No","0","87130","94141","246","181517","0.05"
"2025-09-22T08:39:54.812Z","Included","gemini-2.5-pro","No","0","375942","94056","676","470674","0.41"
"2025-09-22T08:39:03.621Z","Included","gemini-2.5-pro","No","0","274779","0","224","275003","0.25"
"2025-09-22T08:37:47.533Z","Included","gemini-2.5-pro","No","0","91317","181852","288","273457","0.15"
"2025-09-22T08:34:33.727Z","Included","gemini-2.5-pro","No","0","450936","7835","1096","459867","0.49"
"2025-09-22T08:33:08.687Z","Included","gemini-2.5-pro","No","0","173685","0","235","173920","0.13"
"2025-09-22T08:28:41.160Z","Included","gemini-2.5-pro","No","0","169495","187668","1139","358302","0.19"
"2025-09-22T08:24:03.785Z","Included","gemini-2.5-pro","No","0","79831","86330","1070","167231","0.05"
"2025-09-22T08:20:11.456Z","Included","gemini-2.5-pro","No","0","333252","94132","716","428100","0.37"
"2025-09-22T08:00:17.505Z","Included","gemini-2.5-pro","No","0","75507","86328","77","161912","0.04"
"2025-09-22T07:59:06.282Z","Included","gemini-2.5-pro","No","0","78520","82392","347","161259","0.05"
"2025-09-22T07:56:33.081Z","Included","gemini-2.5-pro","No","0","158043","0","680","158723","0.12"
"2025-09-22T07:46:33.949Z","Included","gemini-2.5-pro","No","0","844523","210488","2328","1057339","1.07"
"2025-09-22T07:31:44.033Z","Included","gemini-2.5-pro","No","0","134858","7842","702","143402","0.11"
"2025-09-22T07:10:14.699Z","Included","gemini-2.5-pro","No","0","1214652","972881","6449","2193982","1.88"
"2025-09-22T06:53:44.121Z","Included","grok-code-fast-1","No","0","157704","1383616","795","1542115","0.05"
"2025-09-22T06:46:56.301Z","Included","grok-code-fast-1","No","0","143764","1780992","3282","1928038","0.07"
"2025-09-22T06:39:44.797Z","Included","grok-code-fast-1","No","0","359031","2340928","1965","2701924","0.11"
"2025-09-22T06:08:05.651Z","Included","grok-code-fast-1","No","0","829126","6349312","4670","7183108","0.29"
"2025-09-22T05:53:31.814Z","Included","grok-code-fast-1","No","0","375707","3634688","3249","4013644","0.15"
"2025-09-22T05:27:12.890Z","Included","grok-code-fast-1","No","0","115479","750464","4236","870179","0.04"
"2025-09-21T21:09:40.973Z","Included","auto","No","11276","108227","1715351","3208","1838062","0.60"
"2025-09-21T21:06:02.121Z","Included","auto","No","8910","100678","1219493","2553","1331634","0.46"
"2025-09-21T21:00:13.430Z","Included","auto","No","105213","92286","1591486","3614","1792599","0.67"
"2025-09-21T20:52:50.733Z","Included","auto","No","93888","78973","1040026","2648","1215535","0.49"
"2025-09-21T20:35:49.942Z","Included","auto","No","89863","62432","576573","1901","730769","0.35"
"2025-09-21T20:24:29.317Z","Included","auto","No","37520","23614","807948","2877","871959","0.30"
"2025-09-21T20:20:57.702Z","Included","auto","No","5088","20851","210428","1293","237660","0.09"
"2025-09-21T20:19:27.548Z","Included","auto","No","714","20195","38639","537","60085","0.04"
"2025-09-21T20:03:50.128Z","Included","auto","No","27717","40","1189057","10916","1227730","0.40"
"2025-09-21T19:56:44.385Z","Included","auto","No","120165","111211","656562","12026","899964","0.53"
"2025-09-21T19:53:41.004Z","Included","auto","No","16921","91866","727944","6395","843126","0.36"
"2025-09-21T19:50:21.751Z","Included","auto","No","90700","90598","104627","900","286825","0.26"
"2025-09-21T19:48:30.830Z","Included","auto","No","540","10686","26190","148","37564","0.02"
"2025-09-21T19:41:49.025Z","Included","auto","No","13431","2206","529480","5565","550682","0.19"
"2025-09-21T19:38:21.298Z","Included","auto","No","792","1535","11967","432","14726","0.01"
"2025-09-21T19:36:34.975Z","Included","auto","No","1045","8","22444","953","24450","0.01"
"2025-09-21T13:22:28.340Z","Included","auto","No","89486","50458","919797","3107","1062848","0.42"
"2025-09-21T13:12:20.674Z","Included","auto","No","50035","18","556332","4293","610678","0.23"
"2025-09-20T16:25:15.529Z","Included","auto","No","4089","7861","59784","461","72195","0.03"
"2025-09-20T16:23:42.515Z","Included","auto","No","1074","7438","38080","274","46866","0.02"
"2025-09-20T16:22:23.526Z","Included","auto","No","2255","5674","198355","977","207261","0.07"
"2025-09-20T16:21:10.707Z","Included","auto","No","235","5251","16725","338","22549","0.01"
"2025-09-20T16:18:47.625Z","Included","auto","No","3380","2045","250381","1074","256880","0.08"
"2025-09-20T16:18:07.686Z","Included","auto","No","6092","1546","33587","272","41497","0.02"
"2025-09-20T12:30:44.542Z","Included","auto","No","287","1311","12563","86","14247","0.01"
"2025-09-20T12:30:02.531Z","Included","auto","No","382","917","24641","152","26092","0.01"
"2025-09-20T12:29:48.720Z","Included","auto","No","4974","0","7210","201","12385","0.01"
"2025-09-20T12:13:47.190Z","Included","auto","No","10724","0","127783","1843","140350","0.06"
"2025-09-20T12:04:43.002Z","Included","auto","No","8005","18","194919","2477","205419","0.07"
"2025-09-20T11:56:35.457Z","Included","auto","No","16432","10684","10770","456","38342","0.04"
"2025-09-20T11:52:47.454Z","Included","auto","No","1907","10272","47858","750","60787","0.03"
"2025-09-20T11:48:39.248Z","Included","auto","No","12847","24","109511","2785","125167","0.06"
"2025-09-19T19:30:37.935Z","Included","auto","No","4660","0","40264","773","45697","0.02"
"2025-09-19T19:09:15.824Z","Included","auto","No","10161","14","43851","3006","57032","0.04"
"2025-09-19T18:58:25.571Z","Included","auto","No","81256","50443","1107919","4824","1244442","0.47"
"2025-09-19T18:50:59.506Z","Included","auto","No","68146","48988","322299","1449","440882","0.24"
"2025-09-19T18:41:53.069Z","Included","auto","No","9634","43034","634296","4582","691546","0.25"
"2025-09-19T18:37:19.847Z","Included","auto","No","6452","38564","312842","3230","361088","0.15"
"2025-09-19T18:33:05.857Z","Included","auto","No","48519","35166","337543","4382","425610","0.22"
"2025-09-19T18:19:26.744Z","Included","auto","No","38700","33","213616","3895","256244","0.13"
"2025-09-19T18:01:42.294Z","Included","auto","No","6945","13747","307371","1896","329959","0.11"
"2025-09-19T17:57:45.861Z","Included","auto","No","32956","6979","239789","3420","283144","0.13"
"2025-09-19T17:06:07.891Z","Included","auto","No","1978","5256","75094","462","82790","0.03"
"2025-09-19T17:00:29.146Z","Included","auto","No","6756","0","142878","1442","151076","0.05"
"2025-09-19T16:46:49.776Z","Included","auto","No","199877","182127","2294559","3476","2680039","1.07"
"2025-09-19T16:35:40.952Z","Errored, Not Charged","auto","No","191932","3361","3384900","4337","3584530","1.12"
"2025-09-19T16:15:06.403Z","Included","auto","No","179038","32","3225516","11928","3416514","1.10"
"2025-09-19T14:50:15.116Z","Included","auto","No","42348","24","516623","3784","562779","0.20"
"2025-09-19T14:29:49.357Z","Included","auto","No","52598","0","758424","7301","818323","0.30"
"2025-09-19T09:13:38.742Z","Included","auto","No","32588","4498","432915","3286","473287","0.17"
"2025-09-19T09:11:44.750Z","Included","auto","No","6383","24","70363","1941","78711","0.04"
"2025-09-18T20:32:33.826Z","Included","auto","No","621","54259","88350","739","143969","0.10"
"2025-09-18T20:29:54.965Z","Included","auto","No","6151","50839","682114","2717","741821","0.26"
"2025-09-18T20:27:18.866Z","Included","auto","No","71108","42301","325391","1837","440637","0.23"
"2025-09-18T20:18:40.416Z","Included","auto","No","4585","38707","351047","2447","396786","0.16"
"2025-09-18T20:17:09.342Z","Included","auto","No","113","37656","68249","487","106505","0.07"
"2025-09-18T20:15:16.296Z","Errored, Not Charged","auto","No","1355","38353","65842","637","106187","0.07"
"2025-09-18T20:12:56.049Z","Included","auto","No","486","36753","65356","856","103451","0.07"
"2025-09-18T20:09:34.337Z","Included","auto","No","10135","32967","1092302","4265","1139669","0.35"
"2025-09-18T20:09:12.333Z","Errored, Not Charged","auto","No","44130","33388","11091","193","88802","0.10"
"2025-09-18T19:57:29.286Z","Included","auto","No","43112","11602","1308376","8906","1371996","0.45"
"2025-09-18T19:42:46.204Z","Included","auto","No","1296","25335","50120","539","77290","0.05"
"2025-09-18T19:41:32.910Z","Included","auto","No","968","24618","49152","1158","75896","0.05"
"2025-09-18T19:40:41.935Z","Included","auto","No","588","24055","48564","814","74021","0.05"
"2025-09-18T19:39:00.704Z","Included","auto","No","37473","22043","151276","1665","212457","0.12"
"2025-09-18T19:29:51.284Z","Included","auto","No","34410","24524","99353","1593","159880","0.11"
"2025-09-18T19:20:40.195Z","Included","auto","No","32138","20246","96448","1158","149990","0.10"
"2025-09-18T17:36:44.279Z","Included","auto","No","946","23816","35102","1168","61032","0.05"
"2025-09-18T17:35:49.117Z","Included","auto","No","24011","14150","11091","524","49776","0.05"
"2025-09-18T17:25:09.361Z","Included","auto","No","8280","8644","339758","3833","360515","0.13"
"2025-09-18T17:19:57.838Z","Included","auto","No","10679","1726","440616","5132","458153","0.16"
"2025-09-18T17:17:07.923Z","Included","auto","No","4183","12","40967","997","46159","0.02"
"2025-09-18T17:08:23.036Z","Errored, Not Charged","auto","No","4159","11102","188071","1795","205127","0.08"
"2025-09-18T17:04:58.509Z","Included","auto","No","2138","9482","45636","1609","58865","0.04"
"2025-09-18T17:03:32.917Z","Included","auto","No","11294","23","78650","1438","91405","0.04"
"2025-09-18T16:58:09.185Z","Included","auto","No","10929","2086","371245","4998","389258","0.14"
"2025-09-18T16:56:41.727Z","Included","auto","No","5099","14","41584","777","47474","0.02"
"2025-09-18T16:43:34.110Z","Included","auto","No","8310","47230","599081","4341","658962","0.25"
"2025-09-18T16:39:42.900Z","Included","auto","No","59620","41323","614787","4070","719800","0.30"
"2025-09-18T16:24:15.302Z","Included","auto","No","50237","37346","418982","4201","510766","0.24"
"2025-09-18T16:14:51.923Z","Included","auto","No","43197","31951","370217","3205","448570","0.21"
"2025-09-18T16:11:13.123Z","Included","auto","No","1979","30760","41478","298","74515","0.05"
"2025-09-18T16:09:49.027Z","Included","auto","No","34124","29791","7354","1790","73059","0.09"
"2025-09-18T16:08:36.635Z","Included","auto","No","33591","29588","11091","261","74531","0.08"
"2025-09-18T16:00:51.582Z","Included","auto","No","31088","28310","11091","2066","72555","0.09"
"2025-09-18T15:51:58.516Z","Included","auto","No","29520","14","66381","1995","97910","0.07"
"2025-09-18T14:52:20.791Z","Included","auto","No","5096","34608","255272","2573","297549","0.13"
"2025-09-18T14:49:59.195Z","Included","auto","No","1157","33610","47132","1399","83298","0.06"
"2025-09-18T14:45:41.021Z","Errored, Not Charged","auto","No","461","363","46671","794","48289","0.02"
"2025-09-18T14:42:58.744Z","Included","auto","No","35580","21","162839","1999","200439","0.10"
"2025-09-17T18:11:22.937Z","Included","auto","No","4150","13694","386313","2586","406743","0.13"
"2025-09-17T18:10:14.009Z","Included","auto","No","22215","12809","199828","1475","236327","0.10"
"2025-09-17T17:50:26.105Z","Included","auto","No","13760","7682","192140","2488","216070","0.09"
"2025-09-17T17:49:26.849Z","Included","auto","No","1098","7901","18696","1235","28930","0.02"
"2025-09-17T17:48:01.563Z","Included","auto","No","7605","12","47658","1596","56871","0.03"
"2025-09-17T17:39:01.505Z","Included","auto","No","19407","19","565148","6287","590861","0.20"
"2025-09-17T16:49:50.150Z","Included","auto","No","2377","18283","117741","797","139198","0.06"
"2025-09-17T16:43:12.148Z","Included","auto","No","27124","24","643421","7679","678248","0.24"
"2025-09-17T16:28:21.149Z","Included","auto","No","23282","11484","372805","5485","413056","0.17"
"2025-09-17T16:21:03.092Z","Included","auto","No","13726","26","243237","4296","261285","0.10"
"2025-09-17T16:02:24.609Z","Included","auto","No","120237","106407","1133734","2343","1362721","0.58"
"2025-09-17T15:58:18.610Z","Included","auto","No","5671","103691","2216215","3126","2328703","0.71"
"2025-09-17T15:53:46.223Z","Included","auto","No","2346","102696","498001","952","603995","0.26"
"2025-09-17T15:48:17.069Z","Included","auto","No","3909","100526","979247","2920","1086602","0.39"
"2025-09-17T15:45:12.280Z","Included","auto","No","150103","99047","1284638","3843","1537631","0.66"
"2025-09-17T14:48:08.705Z","Included","auto","No","2422","96791","461651","2443","563307","0.25"
"2025-09-17T14:46:56.787Z","Included","auto","No","741","96368","305945","927","403981","0.20"
"2025-09-17T14:45:07.623Z","Included","auto","No","2462","96435","301291","1066","401254","0.21"
"2025-09-17T14:39:03.869Z","Included","auto","No","11029","94287","1448377","9135","1562828","0.55"
"2025-09-17T14:32:54.771Z","Included","auto","No","128110","135563","1041772","8202","1313647","0.64"
"2025-09-17T14:18:16.411Z","Included","auto","No","4975","40930","1114758","2605","1163268","0.35"
"2025-09-17T14:15:25.641Z","Included","auto","No","3798","38828","751940","2022","796588","0.25"
"2025-09-17T14:08:46.537Z","Included","auto","No","61932","35506","627315","5640","730393","0.31"
"2025-09-17T13:58:56.064Z","Included","auto","No","53474","33398","623887","5104","715863","0.30"
"2025-09-17T13:52:36.867Z","Included","auto","No","45881","34372","340936","2949","424138","0.20"
"2025-09-17T13:34:35.759Z","Included","auto","No","38934","32","912818","8068","959852","0.33"
"2025-09-17T13:24:06.707Z","Included","auto","No","2313","24061","176875","665","203914","0.08"
"2025-09-17T13:19:14.258Z","Included","auto","No","841","21817","100602","454","123714","0.06"
"2025-09-17T13:16:33.454Z","Included","auto","No","5586","19472","214899","966","240923","0.09"
"2025-09-17T12:53:27.121Z","Included","auto","No","19700","0","425282","5208","450190","0.16"
"2025-09-17T12:36:42.320Z","Included","auto","No","37924","157182","6421732","15323","6632161","1.94"
"2025-09-17T12:31:22.460Z","Included","auto","No","146690","21","1102020","805","1249536","0.46"
"2025-09-16T20:53:33.576Z","Included","auto","No","6117","66614","772701","1224","846656","0.29"
"2025-09-16T20:51:18.242Z","Included","auto","No","17690","42446","408640","738","469514","0.18"
"2025-09-16T20:47:42.500Z","Included","auto","No","3219","38986","467743","815","510763","0.17"
"2025-09-16T20:46:53.324Z","Included","auto","No","408","38595","45032","278","84313","0.06"
"2025-09-16T20:45:11.503Z","Included","auto","No","588","38198","44445","256","83487","0.06"
"2025-09-16T20:40:11.820Z","Included","auto","No","14764","26753","584473","986","626976","0.20"
"2025-09-16T20:25:54.179Z","Included","auto","No","128250","162505","2917140","13597","3221492","1.17"
"2025-09-16T20:09:18.037Z","Included","auto","No","751","79812","99018","80","179661","0.13"
"2025-09-16T19:58:43.375Z","Included","auto","No","794","79036","98225","362","178417","0.13"
"2025-09-16T19:42:34.168Z","Included","auto","No","13569","66542","2864765","4821","2949697","0.85"
"2025-09-16T19:40:30.516Z","Included","auto","No","3046","63936","912156","837","979975","0.32"
"2025-09-16T19:32:03.330Z","Included","auto","No","10163","54150","2625611","2930","2692854","0.75"
"2025-09-16T19:27:43.998Z","Included","auto","No","4908","50538","1033280","2720","1091446","0.34"
"2025-09-16T19:21:17.418Z","Included","auto","No","15534","45048","1634264","2158","1697004","0.50"
"2025-09-16T19:12:27.403Z","Included","auto","No","52485","32731","1792110","3673","1880999","0.58"
"2025-09-16T19:02:58.615Z","Included","auto","No","5523","31081","571938","4071","612613","0.21"
"2025-09-16T18:57:41.885Z","Included","auto","No","3414","29470","359590","2832","395306","0.15"
"2025-09-16T18:44:44.570Z","Included","auto","No","5469","0","572108","1791","579368","0.16"
"2025-09-16T18:36:20.417Z","Included","auto","No","2349","22663","189508","629","215149","0.08"
"2025-09-16T18:16:14.419Z","Included","auto","No","7483","15991","586966","2496","612936","0.19"
"2025-09-16T18:12:11.703Z","Included","auto","No","15832","13225","137195","1053","167305","0.08"
"2025-09-16T17:11:01.181Z","Included","auto","No","2209","8996","118367","694","130266","0.05"
"2025-09-16T17:05:45.717Z","Included","auto","No","8129","0","265719","2271","276119","0.09"
"2025-09-16T16:51:48.527Z","Included","auto","No","6208","4890","301942","1680","314720","0.10"
"2025-09-16T16:48:36.396Z","Included","auto","No","3567","0","15429","423","19419","0.01"
"2025-09-16T16:39:18.362Z","Included","auto","No","373","7676","14517","232","22798","0.02"
"2025-09-16T16:38:24.416Z","Included","auto","No","431","7310","14087","288","22116","0.01"
"2025-09-16T16:37:18.885Z","Included","auto","No","480","6906","13608","320","21314","0.01"
"2025-09-16T16:24:47.160Z","Included","auto","No","3827","3022","220606","1190","228645","0.07"
"2025-09-16T16:22:41.752Z","Included","auto","No","1749","1284","62391","808","66232","0.02"
"2025-09-16T16:22:06.229Z","Included","auto","No","325","1001","7734","268","9328","0.01"
"2025-09-16T16:20:17.053Z","Included","auto","No","244","703","7491","299","8737","0.005"
"2025-09-16T16:19:33.124Z","Included","auto","No","382","0","7110","211","7703","0.004"
"2025-09-16T16:17:22.649Z","Included","auto","No","361","8551","15218","351","24481","0.02"
"2025-09-16T16:14:19.597Z","Included","auto","No","602","8207","14617","220","23646","0.02"
"2025-09-16T16:01:35.225Z","Included","auto","No","7512","6473","62233","883","77101","0.04"
"2025-09-15T20:52:49.054Z","Included","auto","No","22380","12620","1414516","12261","1461777","0.47"
"2025-09-15T20:35:40.436Z","Included","auto","No","22291","881","459884","18289","501345","0.25"
"2025-09-15T20:34:26.204Z","Included","auto","No","963","0","22513","388","23864","0.01"
"2025-09-15T20:27:43.897Z","Included","auto","No","8414","39594","426213","6379","480600","0.20"
"2025-09-15T20:25:21.474Z","Included","auto","No","1429","38045","169374","1006","209854","0.10"
"2025-09-15T20:21:58.169Z","Errored, Not Charged","auto","No","35025","178191","7454","14555","235225","0.36"
"2025-09-15T20:12:10.915Z","Included","auto","No","83429","86429","340280","755","510893","0.30"
"2025-09-15T20:08:35.126Z","Included","auto","No","5968","87579","206744","1856","302147","0.18"
"2025-09-15T20:05:47.225Z","Included","auto","No","7097","84351","1026497","2094","1120039","0.38"
"2025-09-15T19:59:28.812Z","Included","auto","No","5571","82202","596536","800","685109","0.26"
"2025-09-15T19:56:57.272Z","Included","auto","No","3699","79549","681441","716","765405","0.28"
"2025-09-15T19:52:55.779Z","Included","auto","No","4448","79166","91920","250","175784","0.13"
"2025-09-15T19:48:47.889Z","Included","auto","No","6694","75581","935285","691","1018251","0.34"
"2025-09-15T19:36:37.230Z","Included","auto","No","85151","73414","917482","1239","1077286","0.44"
"2025-09-15T19:33:16.371Z","Included","auto","No","2868","71516","85637","1425","161446","0.12"
"2025-09-15T19:31:34.027Z","Included","auto","No","5095","69513","343648","534","418790","0.18"
"2025-09-15T19:27:43.091Z","Included","auto","No","6140","66897","417790","936","491763","0.20"
"2025-09-15T19:24:23.412Z","Included","auto","No","9049","63790","481304","690","554833","0.22"
"2025-09-15T19:21:30.354Z","Included","auto","No","86676","57693","1398210","1460","1544039","0.54"
"2025-09-15T19:14:38.626Z","Included","auto","No","8481","49371","1473317","1608","1532777","0.45"
"2025-09-15T19:08:48.100Z","Included","auto","No","13363","49004","53081","98","115546","0.09"
"2025-09-15T19:03:39.548Z","Included","auto","No","17876","35050","90893","168","143987","0.09"
"2025-09-15T18:54:08.425Z","Included","auto","No","25595","24629","678223","8167","736614","0.28"
"2025-09-15T18:48:57.634Z","Included","auto","No","13852","16486","440562","7392","478292","0.19"
"2025-09-15T18:44:40.720Z","Included","auto","No","9651","7516","281449","3410","302026","0.11"
"2025-09-15T18:41:05.365Z","Included","auto","No","4913","0","7455","1288","13656","0.02"
"2025-09-15T18:31:57.696Z","Included","auto","No","8032","42584","355175","2555","408346","0.17"
"2025-09-15T18:23:06.391Z","Included","auto","No","38939","37328","182006","2718","260991","0.16"
"2025-09-15T18:10:04.221Z","Included","auto","No","7580","31451","791552","2003","832586","0.26"
"2025-09-15T18:04:48.984Z","Included","auto","No","26678","0","183064","2117","211859","0.09"
"2025-09-15T18:01:10.924Z","Included","auto","No","8455","87776","95613","398","192242","0.15"
"2025-09-15T17:55:30.411Z","Included","auto","No","8366","80777","1276323","3241","1368707","0.45"
"2025-09-15T17:53:03.002Z","Included","auto","No","3361","77720","841013","1280","923374","0.32"
"2025-09-15T17:49:58.370Z","Included","auto","No","1671","75434","724819","994","802918","0.28"
"2025-09-15T17:44:54.147Z","Included","auto","No","3481","73600","701517","2635","781233","0.29"
"2025-09-15T17:43:52.829Z","Included","auto","No","1290","72106","169605","510","243511","0.14"
"2025-09-15T17:42:22.733Z","Included","auto","No","1505","70895","418809","594","491803","0.20"
"2025-09-15T17:36:56.950Z","Included","auto","No","1253","69795","329936","610","401594","0.17"
"2025-09-15T17:32:16.622Z","Included","auto","No","3223","67495","803497","1477","875692","0.30"
"2025-09-15T17:30:10.098Z","Included","auto","No","1670","65485","387402","894","455451","0.19"
"2025-09-15T17:28:09.277Z","Included","auto","No","1723","64190","532759","642","599314","0.22"
"2025-09-15T17:27:06.389Z","Included","auto","No","1260","63279","448909","432","513880","0.20"
"2025-09-15T17:22:16.824Z","Included","auto","No","67206","58409","1584913","1968","1712496","0.57"
"2025-09-15T16:19:29.545Z","Included","auto","No","6658","53581","519663","3548","583450","0.23"
"2025-09-15T16:17:45.021Z","Included","auto","No","11278","52073","296574","1052","360977","0.16"
"2025-09-15T16:13:55.520Z","Included","auto","No","12296","43431","1093005","5750","1154482","0.38"
"2025-09-15T16:10:21.754Z","Included","auto","No","7096","37260","705481","2359","752196","0.25"
"2025-09-15T16:06:48.046Z","Included","auto","No","8137","34677","232793","1110","276717","0.12"
"2025-09-15T16:02:00.047Z","Included","auto","No","6931","27678","609658","1740","646007","0.21"
"2025-09-15T15:59:18.419Z","Included","auto","No","926","26937","62299","811","90973","0.06"
"2025-09-15T15:55:01.359Z","Included","auto","No","9593","17745","649770","2052","679160","0.21"
"2025-09-15T15:52:38.996Z","Included","auto","No","10418","4856","34763","536","50573","0.03"
"2025-09-15T15:49:36.165Z","Included","auto","No","3744","0","59329","852","63925","0.02"
"2025-09-12T21:10:05.985Z","Included","auto","No","405","7181","15938","106","23630","0.01"
"2025-09-12T21:04:59.043Z","Included","auto","No","364","6812","15575","375","23126","0.01"
"2025-09-12T21:03:49.158Z","Included","auto","No","385","6495","15191","306","22377","0.01"
"2025-09-12T21:02:40.281Z","Errored, Not Charged","auto","No","156","6083","30154","384","36777","0.01"
"2025-09-12T21:01:38.015Z","Included","auto","No","258","5736","14402","327","20723","0.01"
"2025-09-12T21:00:54.260Z","Included","auto","No","6705","5452","7698","82","19937","0.01"
"2025-09-12T21:00:01.035Z","Included","auto","No","2293","0","7276","136","9705","0.005"
"2025-09-12T20:43:15.111Z","Included","auto","No","4208","0","345840","1195","351243","0.10"
"2025-09-12T20:38:56.234Z","Included","auto","No","60381","0","73566","1012","134959","0.08"
"2025-09-12T20:33:26.718Z","Included","auto","No","4135","0","312877","1857","318869","0.09"
"2025-09-12T20:25:49.981Z","Included","auto","No","11160","0","778740","2433","792333","0.22"
"2025-09-12T20:12:23.427Z","Included","auto","No","46917","0","679444","4093","730454","0.23"
"2025-09-12T19:53:30.893Z","Included","auto","No","1024","0","32259","1346","34629","0.01"
"2025-09-12T19:47:21.096Z","Included","auto","No","16705","0","437309","5436","459450","0.15"
"2025-09-12T19:43:30.961Z","Included","auto","No","2871","0","85651","550","89072","0.03"
"2025-09-12T19:36:20.473Z","Included","auto","No","10067","0","14015","924","25006","0.02"
"2025-09-12T18:49:51.918Z","Included","auto","No","28790","0","113710","824","143324","0.06"
"2025-09-12T17:59:06.858Z","Included","auto","No","2842","0","163339","953","167134","0.05"
"2025-09-12T17:53:26.559Z","Included","auto","No","21013","94277","355139","15073","485502","0.18"
"2025-09-12T17:48:37.129Z","Included","auto","No","3862","0","551231","1812","556905","0.15"
"2025-09-12T17:44:29.163Z","Included","auto","No","2316","0","428963","971","432250","0.11"
"2025-09-12T17:38:48.542Z","Included","auto","No","3880","0","732196","1227","737303","0.19"
"2025-09-12T17:33:14.050Z","Included","auto","No","2175","0","404610","929","407714","0.11"
"2025-09-12T17:27:31.004Z","Included","auto","No","2373","0","296410","894","299677","0.08"
"2025-09-12T17:23:43.515Z","Included","auto","No","2192","0","289497","819","292508","0.08"
"2025-09-12T17:22:21.771Z","Included","auto","No","88098","0","7276","562","95936","0.09"
"2025-09-12T17:19:11.293Z","Included","auto","No","4118","0","551333","1484","556935","0.15"
"2025-09-12T17:15:53.549Z","Included","auto","No","3891","0","350000","1895","355786","0.10"
"2025-09-12T17:13:40.078Z","Included","auto","No","1296","0","84462","433","86191","0.02"
"2025-09-12T17:11:33.295Z","Included","auto","No","19613","0","316428","877","336918","0.10"
"2025-09-12T17:08:37.188Z","Included","auto","No","4068","0","378397","1776","384241","0.11"
"2025-09-12T17:05:54.970Z","Included","auto","No","3876","0","473871","1282","479029","0.13"
"2025-09-12T17:03:15.512Z","Included","auto","No","3180","0","333484","1261","337925","0.09"
"2025-09-12T16:56:40.971Z","Included","auto","No","13994","0","804795","3935","822724","0.23"
"2025-09-12T16:44:20.924Z","Included","auto","No","5055","0","188036","954","194045","0.06"
"2025-09-12T16:40:04.900Z","Included","auto","No","3487","0","165485","1497","170469","0.05"
"2025-09-12T16:37:25.072Z","Included","auto","No","21433","99839","181984","9006","312262","0.11"
"2025-09-12T16:35:28.081Z","Included","auto","No","7264","0","649914","3553","660731","0.18"
"2025-09-12T16:31:29.967Z","Included","auto","No","3940","0","310061","3346","317347","0.09"
"2025-09-12T16:28:59.659Z","Included","auto","No","2778","0","300047","2591","305416","0.09"
"2025-09-12T16:23:48.102Z","Included","auto","No","6056","0","583115","2363","591534","0.16"
"2025-09-12T16:20:07.252Z","Included","auto","No","88883","0","387700","912","477495","0.19"
"2025-09-12T08:39:39.926Z","Included","auto","No","26632","0","1616663","6659","1649954","0.46"
"2025-09-12T08:29:24.167Z","Included","auto","No","60056","84852","267979","7633","420520","0.17"
"2025-09-12T08:22:36.710Z","Included","auto","No","6353","0","433576","600","440529","0.12"
"2025-09-12T08:19:57.540Z","Included","auto","No","11992","0","519835","1574","533401","0.15"
"2025-09-12T08:15:36.756Z","Included","auto","No","15312","0","691403","2032","708747","0.20"
"2025-09-12T08:10:54.840Z","Included","auto","No","35687","0","615817","2839","654343","0.20"
"2025-09-12T08:03:52.213Z","Included","auto","No","137898","41320","1611183","17227","1807628","0.61"
"2025-09-12T07:57:08.216Z","Included","auto","No","43124","0","1132907","8531","1184562","0.36"
"2025-09-12T07:54:45.255Z","Included","auto","No","1281","0","53666","254","55201","0.02"
"2025-09-12T07:52:19.238Z","Included","auto","No","13911","0","527318","6163","547392","0.17"
"2025-09-12T07:44:10.660Z","Included","auto","No","10047","0","835606","3826","849479","0.23"
"2025-09-12T07:39:41.970Z","Included","auto","No","21918","0","571921","3947","597786","0.18"
"2025-09-12T07:35:53.044Z","Included","auto","No","15316","0","29632","314","45262","0.02"
"2025-09-12T07:33:27.118Z","Included","auto","No","3369","0","60089","734","64192","0.02"
"2025-09-12T07:29:57.160Z","Included","auto","No","442","0","17710","301","18453","0.01"
"2025-09-12T07:27:54.048Z","Included","auto","No","526","0","17185","297","18008","0.01"
"2025-09-12T07:26:02.493Z","Included","auto","No","10068","0","7118","379","17565","0.01"
"2025-09-12T06:26:07.404Z","Included","auto","No","2871","0","121136","2072","126079","0.04"
"2025-09-12T06:24:12.908Z","Included","auto","No","373","0","13527","308","14208","0.005"
"2025-09-12T06:23:29.831Z","Included","auto","No","475","0","13053","266","13794","0.005"
"2025-09-12T06:20:08.873Z","Included","auto","No","5939","0","146041","2017","153997","0.05"
"2025-09-11T21:20:40.825Z","Included","auto","No","394","0","9151","412","9957","0.004"
"2025-09-11T21:19:34.894Z","Included","auto","No","2043","0","7109","365","9517","0.01"
"2025-09-11T21:06:25.548Z","Included","auto","No","8988","0","911303","3034","923325","0.25"
"2025-09-11T20:57:10.614Z","Included","auto","No","33581","0","540937","2625","577143","0.18"
"2025-09-11T20:54:47.249Z","Included","auto","No","1696","0","171084","530","173310","0.05"
"2025-09-11T20:52:33.434Z","Included","auto","No","26146","0","242489","889","269524","0.09"
"2025-09-11T20:42:35.090Z","Included","auto","No","34930","0","993154","6361","1034445","0.31"
"2025-09-11T20:05:52.476Z","Included","auto","No","5277","0","582582","2863","590722","0.16"
"2025-09-11T20:01:13.961Z","Included","auto","No","4365","0","433112","2524","440001","0.12"
"2025-09-11T19:55:36.610Z","Included","auto","No","38749","0","493055","3934","535738","0.18"
"2025-09-11T19:45:58.713Z","Included","auto","No","8153","0","1603860","2079","1614092","0.42"
"2025-09-11T19:33:31.883Z","Included","auto","No","1759","0","266024","887","268670","0.07"
"2025-09-11T19:29:08.605Z","Included","auto","No","8118","0","2189432","2620","2200170","0.57"
"2025-09-11T19:22:54.988Z","Included","auto","No","26858","0","3533969","9165","3569992","0.95"
"2025-09-11T19:16:30.728Z","Included","auto","No","34278","0","1907017","3563","1944858","0.53"
"2025-09-11T19:11:53.827Z","Included","auto","No","11543","0","153351","2729","167623","0.06"
"2025-09-11T18:02:42.494Z","Included","auto","No","1366","0","384304","393","386063","0.10"
"2025-09-11T18:02:23.580Z","Included","auto","No","1155","0","189572","111","190838","0.05"
"2025-09-11T18:01:56.594Z","Included","auto","No","0","541","0","79","620","0.002"
"2025-09-11T17:50:55.796Z","Included","auto","No","810","0","187641","157","188608","0.05"
"2025-09-11T17:47:34.832Z","Included","auto","No","4952","0","1004161","882","1009995","0.26"
"2025-09-11T17:43:55.542Z","Included","auto","No","2796","0","869619","882","873297","0.22"
"2025-09-11T17:41:18.991Z","Included","auto","No","5443","0","919467","686","925596","0.24"
"2025-09-11T17:30:24.484Z","Included","auto","No","3157","0","788375","1257","792789","0.21"
"2025-09-11T17:28:20.141Z","Included","auto","No","3289","0","608236","713","612238","0.16"
"2025-09-11T17:25:09.939Z","Included","auto","No","3081","0","441150","858","445089","0.12"
"2025-09-11T17:23:03.828Z","Included","auto","No","3733","0","494050","992","498775","0.13"
"2025-09-11T17:14:17.136Z","Included","auto","No","61655","0","870788","1443","933886","0.29"
"2025-09-11T17:06:39.706Z","Included","auto","No","69816","121765","504622","7949","704152","0.24"
"2025-09-11T16:37:45.871Z","Included","auto","No","710","0","48324","1269","50303","0.02"
"2025-09-11T16:35:01.162Z","Included","auto","No","1898","0","141323","1039","144260","0.04"
"2025-09-11T16:34:24.507Z","Included","auto","No","918","0","138861","540","140319","0.04"
"2025-09-11T16:28:59.728Z","Included","auto","No","10514","0","365905","3295","379714","0.12"
"2025-09-11T16:20:44.334Z","Included","auto","No","2947","0","213928","2213","219088","0.07"
"2025-09-11T16:17:18.876Z","Included","auto","No","784","0","33262","491","34537","0.01"
"2025-09-11T16:15:30.290Z","Included","auto","No","717","0","32546","561","33824","0.01"
"2025-09-11T16:09:46.370Z","Included","auto","No","1666","0","160298","643","162607","0.04"
"2025-09-11T16:07:35.288Z","Included","auto","No","4838","0","230119","4129","239086","0.08"
"2025-09-11T16:00:43.443Z","Included","auto","No","17395","0","710003","3962","731360","0.21"
"2025-09-11T15:59:14.978Z","Included","auto","No","2017","0","7109","165","9291","0.004"
"2025-09-11T13:09:21.042Z","Included","auto","No","13337","83902","269878","5768","372885","0.11"
"2025-09-11T13:02:02.979Z","Included","auto","No","4612","0","963755","2294","970661","0.25"
"2025-09-11T12:52:05.043Z","Included","auto","No","5075","0","612128","3438","620641","0.17"
"2025-09-11T12:46:58.131Z","Included","auto","No","4414","0","780350","2448","787212","0.21"
"2025-09-11T12:43:24.257Z","Included","auto","No","88133","0","920859","3551","1012543","0.33"
"2025-09-11T12:38:25.151Z","Included","auto","No","11719","0","575429","3366","590514","0.17"
"2025-09-11T12:34:57.467Z","Included","auto","No","7173","0","611674","2832","621679","0.17"
"2025-09-11T12:27:29.687Z","Included","auto","No","6995","0","836777","2675","846447","0.23"
"2025-09-11T12:23:58.426Z","Included","auto","No","10146","0","543549","4177","557872","0.16"
"2025-09-11T12:20:21.084Z","Included","auto","No","2737","0","494088","802","497627","0.13"
"2025-09-11T12:17:38.422Z","Included","auto","No","4847","0","403303","1881","410031","0.11"
"2025-09-11T12:12:03.910Z","Included","auto","No","2638","0","379378","1076","383092","0.10"
"2025-09-11T12:09:36.512Z","Included","auto","No","1628","0","180337","560","182525","0.05"
"2025-09-11T12:07:41.644Z","Included","auto","No","699","0","43536","423","44658","0.01"
"2025-09-11T12:04:47.084Z","Included","auto","No","13452","0","290759","865","305076","0.09"
"2025-09-11T12:02:23.501Z","Included","auto","No","842","0","29251","411","30504","0.01"
"2025-09-11T11:58:50.928Z","Included","auto","No","6509","0","49035","3178","58722","0.03"
"2025-09-11T11:55:23.151Z","Included","auto","No","15375","0","386654","4466","406495","0.13"
"2025-09-11T11:47:10.813Z","Included","auto","No","6638","0","1002104","2362","1011104","0.27"
"2025-09-11T11:42:18.941Z","Included","auto","No","2326","0","201097","1165","204588","0.06"
"2025-09-11T11:40:02.730Z","Included","auto","No","58817","0","395075","1306","455198","0.16"
"2025-09-11T11:33:04.744Z","Included","auto","No","4597","0","544644","1983","551224","0.15"
"2025-09-11T11:31:29.250Z","Included","auto","No","2487","0","342946","1117","346550","0.09"
"2025-09-11T11:26:45.771Z","Included","auto","No","46716","93907","630472","7574","778669","0.25"
"2025-09-11T11:23:37.490Z","Included","auto","No","4557","0","549834","2239","556630","0.15"
"2025-09-11T11:19:04.469Z","Included","auto","No","100654","0","537024","2051","639729","0.24"
"2025-09-11T11:09:42.416Z","Included","auto","No","2629","0","287929","1195","291753","0.08"
"2025-09-11T11:08:07.337Z","Included","auto","No","2720","0","207540","1356","211616","0.06"
"2025-09-11T11:04:59.662Z","Included","auto","No","60891","0","272575","1862","335328","0.14"
"2025-09-11T10:31:30.874Z","Included","auto","No","5237","0","421158","1695","428090","0.12"
"2025-09-11T10:27:40.447Z","Included","auto","No","7025","0","545147","3218","555390","0.16"
"2025-09-11T10:24:31.762Z","Included","auto","No","44179","0","452053","997","497229","0.16"
"2025-09-11T10:12:50.765Z","Included","auto","No","36411","0","130142","3991","170544","0.08"
"2025-09-11T07:01:42.296Z","Included","auto","No","11754","0","505017","3147","519918","0.15"
"2025-09-11T06:53:12.218Z","Included","auto","No","19785","0","352813","9449","382047","0.15"
"2025-09-11T06:28:17.537Z","Included","auto","No","8947","0","1026110","3651","1038708","0.28"
"2025-09-11T06:21:53.412Z","Errored, Not Charged","auto","No","46733","0","1211738","6346","1264817","0.38"
"2025-09-11T06:10:49.456Z","Included","auto","No","28093","0","701630","9131","738854","0.24"
"2025-09-11T06:04:58.400Z","Included","auto","No","86219","0","192824","568","279611","0.14"
"2025-09-11T05:51:18.899Z","Included","auto","No","14984","0","266098","2729","283811","0.09"
"2025-09-10T17:24:25.053Z","Included","auto","No","3689","0","360831","2576","367096","0.10"
"2025-09-10T17:13:27.596Z","Errored, Not Charged","auto","No","142050","0","3012997","9496","3164543","0.93"
"2025-09-10T17:04:37.254Z","Included","auto","No","58301","0","452459","2116","512876","0.18"
"2025-09-10T16:14:02.659Z","Included","auto","No","53360","0","755775","13229","822364","0.30"
"2025-09-10T14:57:36.825Z","Included","auto","No","32196","0","731515","9788","773499","0.25"
"2025-09-10T14:42:26.446Z","Included","auto","No","549","0","17914","215","18678","0.01"
"2025-09-10T14:39:06.414Z","Included","auto","No","10817","0","150140","1357","162314","0.05"
"2025-09-10T14:29:23.614Z","Included","auto","No","795","0","51234","195","52224","0.01"
"2025-09-10T14:27:46.533Z","Included","auto","No","735","0","50500","660","51895","0.02"
"2025-09-10T14:25:26.118Z","Included","auto","No","43392","0","7109","584","51085","0.05"
"2025-09-09T17:55:02.199Z","Included","auto","No","490","0","49286","321","50097","0.01"
"2025-09-09T17:50:11.605Z","Included","auto","No","466","0","48821","261","49548","0.01"
"2025-09-09T17:48:01.082Z","Included","auto","No","887","0","47935","357","49179","0.01"
"2025-09-09T17:45:00.101Z","Included","auto","No","40808","0","7128","746","48682","0.05"
"2025-09-08T23:37:21.935Z","Included","auto","No","625","0","46806","310","47741","0.01"
"2025-09-08T23:36:32.633Z","Included","auto","No","972","0","45835","493","47300","0.01"
"2025-09-08T23:34:08.325Z","Included","auto","No","790","0","45046","456","46292","0.01"
"2025-09-08T23:33:08.582Z","Included","auto","No","349","0","44698","607","45654","0.01"
"2025-09-08T23:32:29.735Z","Included","auto","No","710","0","43989","176","44875","0.01"
"2025-09-08T23:31:45.186Z","Included","auto","No","484","0","43506","548","44538","0.01"
"2025-09-08T23:27:14.727Z","Included","auto","No","36396","0","7111","282","43789","0.04"
"2025-09-08T23:14:57.870Z","Included","auto","No","869","0","41638","504","43011","0.01"
"2025-09-08T23:02:36.823Z","Included","auto","No","1124","0","40515","743","42382","0.01"
"2025-09-08T22:56:20.919Z","Included","auto","No","1107","0","39409","563","41079","0.01"
"2025-09-08T22:50:46.736Z","Included","auto","No","1718","0","76567","578","78863","0.02"
"2025-09-08T22:44:15.394Z","Included","auto","No","1157","0","36537","661","38355","0.01"
"2025-09-08T22:39:57.799Z","Included","auto","No","599","0","35939","370","36908","0.01"
"2025-09-08T22:39:45.829Z","Included","auto","No","864","0","35076","356","36296","0.01"
"2025-09-08T22:34:51.978Z","Included","auto","No","1071","0","34006","397","35474","0.01"
"2025-09-08T22:32:52.679Z","Included","auto","No","648","0","33359","486","34493","0.01"
"2025-09-08T22:32:34.365Z","Included","auto","No","1070","0","32290","504","33864","0.01"
"2025-09-08T22:31:05.361Z","Included","auto","No","572","0","31719","489","32780","0.01"
"2025-09-08T22:30:21.036Z","Included","auto","No","555","0","31165","458","32178","0.01"
"2025-09-08T22:27:48.205Z","Included","auto","No","2106","0","29060","395","31561","0.01"
"2025-09-08T22:19:55.817Z","Included","auto","No","21933","62121","7128","17739","108921","0.10"
"2025-09-08T22:17:27.376Z","Included","auto","No","4179","0","642278","2766","649223","0.18"
"2025-09-08T22:16:05.289Z","Errored, Not Charged","auto","No","3488","0","311512","964","315964","0.09"
"2025-09-08T22:12:08.704Z","Included","auto","No","5268","0","817304","2039","824611","0.22"
"2025-09-08T22:05:09.489Z","Included","auto","No","4165","0","395054","1850","401069","0.11"
"2025-09-08T22:02:03.964Z","Included","auto","No","7650","0","655884","2458","665992","0.18"
"2025-09-08T21:48:32.258Z","Included","auto","No","5497","0","1081152","3015","1089664","0.29"
"2025-09-08T21:45:55.758Z","Included","auto","No","3809","0","83456","748","88013","0.03"
"2025-09-08T21:30:15.322Z","Included","auto","No","5265","0","502015","1591","508871","0.14"
"2025-09-08T21:18:14.810Z","Included","auto","No","73585","0","870666","2030","946281","0.30"
"2025-09-08T15:45:34.383Z","Included","auto","No","17970","0","2480968","6357","2505295","0.66"
"2025-09-08T15:33:53.454Z","Errored, Not Charged","auto","No","48934","0","1500769","9927","1559630","0.46"
"2025-09-08T13:45:59.679Z","Included","auto","No","31221","0","938127","19330","988678","0.34"
"2025-09-07T14:11:36.193Z","Included","auto","No","24840","0","741293","7034","773167","0.24"
"2025-09-07T13:57:27.364Z","Included","auto","No","29118","0","1571740","2638","1603496","0.43"
"2025-09-07T13:54:19.584Z","Included","auto","No","42745","0","7515","1526","51786","0.05"
"2025-09-07T13:47:25.225Z","Included","auto","No","5203","0","725567","1791","732561","0.19"
"2025-09-07T13:40:06.037Z","Included","auto","No","23241","0","904624","5287","933152","0.27"
"2025-09-07T13:32:59.142Z","Included","auto","No","57983","0","667898","5936","731817","0.25"
"2025-09-07T11:45:52.442Z","Included","auto","No","25814","77983","140441","6072","250310","0.09"
"2025-09-07T11:41:56.358Z","Included","auto","No","95330","0","1301356","2741","1399427","0.43"
"2025-09-07T10:26:40.102Z","Included","auto","No","13413","0","1979793","3299","1996505","0.52"
"2025-09-07T10:13:01.897Z","Included","auto","No","14257","0","2605903","5264","2625424","0.69"
"2025-09-07T10:04:57.632Z","Included","auto","No","17456","0","1395183","6827","1419466","0.39"
"2025-09-07T09:54:23.274Z","Included","auto","No","38632","0","1121831","6466","1166929","0.34"
"2025-09-07T05:57:36.877Z","Included","auto","No","9553","0","89531","1737","100821","0.04"
"2025-09-07T05:44:13.791Z","Included","auto","No","3642","0","746804","1708","752154","0.20"
"2025-09-07T05:26:54.528Z","Errored, Not Charged","auto","No","465","0","71702","243","72410","0.02"
"2025-09-07T05:21:07.071Z","Included","auto","No","5594","0","686816","2505","694915","0.19"
"2025-09-07T05:16:11.598Z","Errored, Not Charged","auto","No","21762","0","1458375","2875","1483012","0.40"
"2025-09-07T05:13:05.558Z","Included","auto","No","40005","0","327191","1803","368999","0.13"
"2025-09-07T05:10:59.633Z","Errored, Not Charged","auto","No","0","0","0","0","0","0.00"
"2025-09-07T05:08:10.879Z","Errored, Not Charged","auto","No","8102","0","48990","275","57367","0.02"
"2025-09-06T20:49:59.405Z","Errored, Not Charged","auto","No","4878","0","962894","1236","969008","0.25"
"2025-09-06T20:47:50.112Z","Errored, Not Charged","auto","No","208","0","77026","214","77448","0.02"
"2025-09-06T20:46:12.549Z","Errored, Not Charged","auto","No","3460","0","73389","164","77013","0.02"
"2025-09-06T20:38:32.400Z","Included","auto","No","5414","0","743622","1498","750534","0.20"
"2025-09-06T20:36:28.778Z","Included","auto","No","3774","0","485681","1478","490933","0.13"
"2025-09-06T20:32:28.652Z","Included","auto","No","7397","0","1092883","2356","1102636","0.29"
"2025-09-06T20:28:13.893Z","Included","auto","No","2189","0","412295","987","415471","0.11"
"2025-09-06T20:20:29.701Z","Included","auto","No","3798","0","394214","834","398846","0.11"
"2025-09-06T20:16:11.046Z","Included","auto","No","5327","0","636970","1851","644148","0.17"
"2025-09-06T20:14:03.748Z","Errored, Not Charged","auto","No","5067","0","281089","573","286729","0.08"
"2025-09-06T20:10:32.118Z","Included","auto","No","5532","0","297604","779","303915","0.08"
"2025-09-06T20:07:16.345Z","Included","auto","No","35253","0","170058","320","205631","0.08"
"2025-09-06T19:54:15.676Z","Included","auto","No","4718","0","479177","1293","485188","0.13"
"2025-09-06T19:54:01.488Z","Included","auto","No","686","0","68254","489","69429","0.02"
"2025-09-06T19:48:58.713Z","Included","auto","No","26263","0","535057","6621","567941","0.19"
"2025-09-06T19:40:47.529Z","Included","auto","No","4219","0","65727","296","70242","0.02"
"2025-09-06T19:36:45.987Z","Included","auto","No","4229","0","397478","2149","403856","0.11"
"2025-09-06T19:32:10.384Z","Included","auto","No","5682","0","990727","1849","998258","0.26"
"2025-09-06T19:22:14.814Z","Included","auto","No","6234","0","838928","1098","846260","0.22"
"2025-09-06T19:13:14.763Z","Included","auto","No","5618","0","748527","1867","756012","0.20"
"2025-09-06T19:08:28.479Z","Included","auto","No","11638","0","1334417","4164","1350219","0.36"
"2025-09-06T19:04:34.459Z","Errored, Not Charged","auto","No","1411","0","137143","479","139033","0.04"
"2025-09-06T18:59:12.489Z","Included","auto","No","8436","0","242016","2948","253400","0.08"
"2025-09-06T18:55:49.787Z","Included","auto","No","21128","106680","219994","4653","352455","0.11"
"2025-09-06T17:31:50.855Z","Included","auto","No","11078","0","1446963","3958","1461999","0.39"
"2025-09-06T17:30:20.424Z","Included","auto","No","1396","0","208363","403","210162","0.06"
"2025-09-06T17:20:58.653Z","Included","auto","No","6700","0","1006213","3694","1016607","0.27"
"2025-09-06T17:11:02.740Z","Included","auto","No","8376","0","929449","3620","941445","0.26"
"2025-09-06T17:08:34.638Z","Included","auto","No","1201","0","87332","394","88927","0.02"
"2025-09-06T17:02:58.089Z","Included","auto","No","80233","0","842319","2665","925217","0.30"
"2025-09-06T13:36:25.071Z","Included","auto","No","71066","0","1246115","3591","1320772","0.40"
"2025-09-06T13:26:05.871Z","Included","auto","No","7369","0","1502156","2866","1512391","0.39"
"2025-09-06T13:23:18.254Z","Included","auto","No","4167","0","757060","2236","763463","0.20"
"2025-09-06T13:17:33.367Z","Errored, Not Charged","auto","No","84381","0","1136342","3745","1224468","0.38"
"2025-09-06T13:13:34.038Z","Included","auto","No","1116","0","149385","401","150902","0.04"
"2025-09-06T12:59:22.587Z","Errored, Not Charged","auto","No","8852","0","684360","4678","697890","0.20"
"2025-09-06T12:41:16.979Z","Included","auto","No","19281","0","710727","1777","731785","0.20"
"2025-09-06T12:40:38.557Z","Included","auto","No","4701","0","45211","1","49913","0.02"
"2025-09-06T12:40:35.470Z","Errored, Not Charged","auto","No","0","0","0","0","0","0.00"
"2025-09-06T12:34:58.865Z","Errored, Not Charged","auto","No","4280","0","375948","1718","381946","0.11"
"2025-09-06T12:16:23.637Z","Errored, Not Charged","auto","No","32765","0","298020","2307","333092","0.12"
"2025-09-05T21:09:53.606Z","Included","auto","No","5820","0","406457","1755","414032","0.11"
"2025-09-05T21:03:14.452Z","Included","auto","No","2890","0","173746","1155","177791","0.05"
"2025-09-05T21:00:30.994Z","Included","auto","No","4863","0","144474","947","150284","0.04"
"2025-09-05T20:56:41.867Z","Included","auto","No","2274","0","104333","678","107285","0.03"
"2025-09-05T20:55:32.076Z","Errored, Not Charged","auto","No","1341","0","45909","257","47507","0.01"
"2025-09-05T20:51:26.175Z","Included","auto","No","7494","0","166752","1351","175597","0.05"
"2025-09-05T20:43:06.773Z","Included","auto","No","1734","0","165547","595","167876","0.05"
"2025-09-05T20:40:18.719Z","Included","auto","No","2305","0","242090","1165","245560","0.07"
"2025-09-05T20:22:35.356Z","Included","auto","No","2788","0","470494","758","474040","0.12"
"2025-09-05T20:19:49.381Z","Included","auto","No","6155","0","367128","1203","374486","0.10"
"2025-09-05T20:18:50.447Z","Included","auto","No","900","0","70056","329","71285","0.02"
"2025-09-05T20:10:10.791Z","Included","auto","No","2653","0","136306","859","139818","0.04"
"2025-09-05T20:07:06.877Z","Included","auto","No","1141","0","134213","686","136040","0.04"
"2025-09-05T20:05:39.629Z","Included","auto","No","868","0","65953","395","67216","0.02"
"2025-09-05T20:02:50.260Z","Included","auto","No","5870","0","60084","414","66368","0.02"
"2025-09-05T19:50:48.468Z","Included","auto","No","53835","0","127761","790","182386","0.09"
"2025-09-05T19:41:43.152Z","Included","auto","No","1781","0","56937","470","59188","0.02"
"2025-09-05T19:37:33.575Z","Included","auto","No","806","0","56132","369","57307","0.02"
"2025-09-05T19:32:00.378Z","Included","auto","No","1795","0","220056","707","222558","0.06"
"2025-09-05T19:29:28.416Z","Included","auto","No","2046","0","52296","331","54673","0.02"
"2025-09-05T19:21:32.798Z","Included","auto","No","498","0","51799","428","52725","0.02"
"2025-09-05T19:18:39.511Z","Included","auto","No","977","0","102123","531","103631","0.03"
"2025-09-05T19:17:36.216Z","Included","auto","No","440","0","50385","328","51153","0.01"
"2025-09-05T19:14:38.346Z","Included","auto","No","2638","0","97586","454","100678","0.03"
"2025-09-05T19:03:47.142Z","Included","auto","No","8411","0","86714","355","95480","0.03"
"2025-09-05T18:48:36.629Z","Included","auto","No","32212","0","45983","461","78656","0.05"
"2025-09-05T18:25:40.887Z","Included","auto","No","5686","0","66511","397","72594","0.02"
"2025-09-05T18:14:40.298Z","Included","auto","No","666","0","29972","359","30997","0.01"
"2025-09-05T18:12:44.311Z","Included","auto","No","1592","0","28381","410","30383","0.01"
"2025-09-05T18:09:14.992Z","Included","auto","No","3119","0","112220","721","116060","0.03"
"2025-09-05T18:07:00.656Z","Included","auto","No","1595","0","105956","875","108426","0.03"
"2025-09-05T17:58:09.783Z","Included","auto","No","1243","0","24505","369","26117","0.01"
"2025-09-05T17:55:30.223Z","Included","auto","No","532","0","23974","380","24886","0.01"
"2025-09-05T17:52:29.636Z","Included","auto","No","1048","0","22927","346","24321","0.01"
"2025-09-05T17:49:00.324Z","Included","auto","No","870","0","22058","327","23255","0.01"
"2025-09-05T17:44:39.133Z","Included","auto","No","1535","0","63620","738","65893","0.02"
"2025-09-05T17:35:39.476Z","Errored, Not Charged","auto","No","13411","0","266259","982","280652","0.08"
"2025-09-05T17:26:22.355Z","Included","auto","No","8709","0","115847","997","125553","0.04"
"2025-09-05T13:58:59.855Z","Included","auto","No","8174","0","263399","3993","275566","0.09"
"2025-09-05T13:51:21.358Z","Errored, Not Charged","auto","No","0","93984","0","6019","100003","0.04"
"2025-09-05T13:35:42.354Z","Included","auto","No","3711","0","541957","2997","548665","0.15"
"2025-09-05T13:32:59.040Z","Included","auto","No","715","0","641583","140","642438","0.16"
"2025-09-05T13:31:49.252Z","Included","auto","No","42877","0","63552","368","106797","0.06"
"2025-09-05T13:29:01.927Z","Errored, Not Charged","auto","No","3647","0","180257","3358","187262","0.06"
"2025-09-05T13:24:29.719Z","Included","auto","No","3622","0","287276","2126","293024","0.08"
"2025-09-05T13:21:11.459Z","Included","auto","No","48810","0","62152","702","111664","0.07"
"2025-09-05T13:16:52.948Z","Included","auto","No","47128","0","925365","2627","975120","0.29"
"2025-09-05T07:55:11.845Z","Included","auto","No","40700","0","424913","1361","466974","0.15"
"2025-09-04T16:57:55.716Z","Included","auto","No","6059","0","6793","78","12930","0.01"
"2025-09-04T16:52:18.245Z","Included","auto","No","5578","0","53444","641","59663","0.02"
"2025-09-04T16:45:46.444Z","Included","auto","No","1056","0","42067","492","43615","0.01"
"2025-09-04T16:42:47.043Z","Included","auto","No","1474","0","36752","511","38737","0.01"
"2025-09-04T16:33:41.918Z","Errored, Not Charged","auto","No","585","0","15726","154","16465","0.01"
"2025-09-04T16:32:26.479Z","Included","auto","No","180","0","7515","288","7983","0.003"
"2025-09-04T16:30:03.054Z","Included","auto","No","82","0","7434","139","7655","0.002"
"2025-09-04T16:29:26.632Z","Included","auto","No","320","0","7115","43","7478","0.002"
"2025-09-04T16:13:37.323Z","Included","auto","No","36938","0","7112","337","44387","0.04"
"2025-09-04T15:09:04.670Z","Included","auto","No","904","0","86566","98","87568","0.02"
"2025-09-04T15:04:43.843Z","Included","auto","No","2103","0","210285","580","212968","0.06"
"2025-09-04T15:00:41.698Z","Included","auto","No","34252","0","239516","1999","275767","0.10"
"2025-09-04T14:55:44.554Z","Included","auto","No","3624","0","171764","1504","176892","0.05"
"2025-09-04T14:51:20.263Z","Included","auto","No","25892","0","248889","3403","278184","0.10"
"2025-09-04T14:48:37.923Z","Included","auto","No","6929","0","120150","3272","130351","0.05"
"2025-09-04T14:46:35.794Z","Included","auto","No","16007","0","70173","1968","88148","0.04"
"2025-09-04T14:39:10.552Z","Included","auto","No","9115","0","248666","3823","261604","0.09"
"2025-09-04T14:35:10.836Z","Included","auto","No","315","0","9891","436","10642","0.005"
"2025-09-04T14:33:06.777Z","Included","auto","No","252","0","9640","148","10040","0.003"
"2025-09-04T14:32:03.853Z","Included","auto","No","566","0","27729","286","28581","0.01"
"2025-09-04T14:31:43.281Z","Included","auto","No","69","0","9009","124","9202","0.003"
"2025-09-04T14:31:11.946Z","Included","auto","No","1398","0","7612","49","9059","0.003"
"2025-09-04T14:26:05.249Z","Included","auto","No","1833","0","313042","936","315811","0.08"
"2025-09-04T14:23:17.993Z","Included","auto","No","1744","0","305857","899","308500","0.08"
"2025-09-04T14:21:05.600Z","Included","auto","No","1387","0","300035","735","302157","0.08"
"2025-09-04T14:18:04.372Z","Included","auto","No","2386","0","512418","805","515609","0.13"
"2025-09-04T14:09:39.348Z","Included","auto","No","3702","0","561618","1682","567002","0.15"
"2025-09-04T14:07:21.423Z","Included","auto","No","2869","0","333772","1308","337949","0.09"
"2025-09-04T14:00:26.319Z","Included","auto","No","57956","0","248547","1230","307733","0.13"
"2025-09-04T13:57:26.739Z","Included","auto","No","511","0","55382","145","56038","0.01"
"2025-09-04T13:56:33.702Z","Included","auto","No","1395","0","53988","401","55784","0.02"
"2025-09-04T13:47:32.310Z","Included","auto","No","22261","0","528624","2549","553434","0.16"
"2025-09-04T13:41:32.141Z","Included","auto","No","25575","0","68531","776","94882","0.05"
"2025-09-04T13:30:14.019Z","Errored, Not Charged","auto","No","20027","75479","136186","8821","240513","0.10"
"2025-09-04T13:13:38.315Z","Errored, Not Charged","auto","No","1061","0","104140","3433","108634","0.04"
"2025-09-04T13:03:12.154Z","Included","auto","No","6334","0","400258","2917","409509","0.12"
"2025-09-04T13:01:43.232Z","Included","auto","No","2487","0","192569","642","195698","0.05"
"2025-09-04T12:55:06.925Z","Included","auto","No","0","4122","0","29","4151","0.01"
"2025-09-04T12:49:27.952Z","Included","auto","No","88199","0","193829","1134","283162","0.14"
"2025-09-04T12:38:12.730Z","Errored, Not Charged","auto","No","0","0","0","0","0","0.00"
"2025-09-04T11:04:54.938Z","Errored, Not Charged","auto","No","0","0","0","0","0","0.00"
"2025-09-04T10:26:27.271Z","Errored, Not Charged","auto","No","239","0","87533","44","87816","0.02"
"2025-09-04T10:25:33.173Z","Included","auto","No","2013","0","346592","212","348817","0.09"
"2025-09-04T10:21:00.452Z","Included","auto","No","78401","0","425327","2979","506707","0.20"
"2025-09-04T10:00:16.767Z","Errored, Not Charged","auto","No","74467","0","7129","0","81596","0.08"
"2025-09-04T09:21:55.986Z","Errored, Not Charged","auto","No","65895","0","715526","40109","821530","0.41"
"2025-09-04T09:17:57.932Z","Errored, Not Charged","auto","No","16446","0","83723","415","100584","0.04"
"2025-09-04T09:16:55.940Z","Included","auto","No","215","0","7859","78","8152","0.002"
"2025-09-04T09:14:31.783Z","Included","auto","No","731","0","7129","82","7942","0.003"
"2025-09-04T06:01:15.185Z","Included","auto","No","1879","0","7515","336","9730","0.01"
"2025-09-04T05:49:13.574Z","Included","auto","No","97309","0","1123575","3976","1224860","0.39"
"2025-09-04T05:35:12.211Z","Included","auto","No","23251","0","1714542","6004","1743797","0.48"
"2025-09-04T05:31:44.957Z","Included","auto","No","12336","0","710821","1071","724228","0.19"
"2025-09-04T05:29:39.633Z","Included","auto","No","65733","0","7110","238","73081","0.07"
"2025-09-03T22:59:34.639Z","Included","auto","No","1066","0","70994","349","72409","0.02"
"2025-09-03T22:55:40.565Z","Included","auto","No","22202","0","529444","1387","553033","0.16"
"2025-09-03T22:50:21.503Z","Included","auto","No","66354","73373","2228413","6069","2374209","0.66"
"2025-09-03T22:47:03.709Z","Included","auto","No","19593","0","1021364","1365","1042322","0.28"
"2025-09-03T22:41:23.398Z","Errored, Not Charged","auto","No","6944","0","404665","5595","417204","0.13"
"2025-09-03T22:38:03.011Z","Errored, Not Charged","auto","No","0","0","0","0","0","0.00"
"2025-09-03T22:33:35.245Z","Included","auto","No","35056","0","1599355","2418","1636829","0.44"
"2025-09-03T22:28:54.018Z","Included","auto","No","14184","0","651039","5208","670431","0.20"
"2025-09-03T22:23:43.825Z","Included","auto","No","16252","0","375942","4874","397068","0.13"
"2025-09-03T22:23:00.349Z","Included","auto","No","8625","0","16010","817","25452","0.02"
"2025-09-03T21:27:03.852Z","Included","auto","No","26048","0","1895592","7607","1929247","0.53"
"2025-09-03T21:20:42.053Z","Included","auto","No","20750","0","239249","1965","261964","0.09"
"2025-09-03T21:08:52.174Z","Included","auto","No","21505","0","1084092","4494","1110091","0.31"
"2025-09-03T20:43:14.697Z","Included","auto","No","35260","0","1363353","5181","1403794","0.40"
"2025-09-03T20:30:13.879Z","Included","auto","No","18487","0","123639","862","142988","0.05"
"2025-09-03T20:21:14.395Z","Errored, Not Charged","auto","No","2096","0","180381","613","183090","0.05"
"2025-09-03T20:13:41.498Z","Included","auto","No","5070","0","569847","3485","578402","0.16"
"2025-09-03T20:06:00.428Z","Included","auto","No","47312","0","1170219","2120","1219651","0.35"
"2025-09-03T19:58:25.673Z","Included","auto","No","65056","51","1411516","3895","1480518","0.66"
"2025-09-03T19:50:30.585Z","Errored, Not Charged","auto","No","53732","81309","468209","12205","615455","0.23"
"2025-09-03T19:37:03.987Z","Included","auto","No","8283","0","3139196","3575","3151054","0.81"
"2025-09-03T19:35:14.734Z","Errored, Not Charged","auto","No","2348","0","317350","759","320457","0.08"
"2025-09-03T19:28:14.248Z","Included","auto","No","16926","0","1763529","4408","1784863","0.48"
"2025-09-03T19:24:36.625Z","Errored, Not Charged","auto","No","3642","0","600220","781","604643","0.16"
"2025-09-03T19:13:01.210Z","Included","auto","No","22986","0","1708947","5934","1737867","0.47"
"2025-09-03T19:02:23.809Z","Included","auto","No","66028","0","1206883","8473","1281384","0.40"
"2025-09-03T18:43:39.245Z","Included","auto","No","51445","85965","1905977","26853","2070240","0.64"
"2025-09-03T18:34:09.088Z","Included","auto","No","6733","0","1216741","3897","1227371","0.33"
"2025-09-03T18:30:24.618Z","Included","auto","No","4300","0","632199","2294","638793","0.17"
"2025-09-03T18:19:45.574Z","Included","auto","No","28601","0","3174487","18634","3221722","0.90"
"2025-09-03T18:13:13.958Z","Included","auto","No","50218","0","548082","3268","601568","0.20"
"2025-09-03T18:07:03.623Z","Included","auto","No","28650","64370","467258","9945","570223","0.19"
"2025-09-03T17:54:37.020Z","Included","auto","No","103147","0","1364163","4235","1471545","0.46"
"2025-09-03T16:22:21.445Z","Errored, Not Charged","auto","No","19165","0","1946788","9189","1975142","0.54"
"2025-09-03T16:16:45.080Z","Included","auto","No","6979","0","467214","5103","479296","0.14"
"2025-09-03T16:06:41.796Z","Included","auto","No","122783","0","1067317","19800","1209900","0.47"
"2025-09-03T15:17:38.183Z","Included","auto","No","998","0","46006","1250","48254","0.02"
"2025-09-03T15:15:08.661Z","Included","auto","No","1172","0","44835","845","46852","0.02"
"2025-09-03T15:10:09.739Z","Included","auto","No","37738","0","608153","3944","649835","0.21"
"2025-09-03T15:00:04.916Z","Included","auto","No","22630","0","454398","6085","483113","0.16"
"2025-09-03T14:58:47.945Z","Included","auto","No","4310","0","39514","136","43960","0.01"
"2025-09-03T14:55:53.000Z","Included","auto","No","4547","0","244949","2686","252182","0.08"
"2025-09-03T14:48:39.483Z","Errored, Not Charged","auto","No","30011","0","211050","2974","244035","0.09"
"2025-09-03T14:21:56.893Z","Included","auto","No","24290","0","619522","3925","647737","0.19"
"2025-09-03T14:13:01.783Z","Included","auto","No","981","0","25637","502","27120","0.01"
"2025-09-03T14:11:06.692Z","Included","auto","No","3791","0","51194","982","55967","0.02"
"2025-09-03T14:08:28.803Z","Included","auto","No","1617","0","23146","489","25252","0.01"
"2025-09-02T21:06:25.080Z","Included","auto","No","25892","0","1658050","8777","1692719","0.48"
"2025-09-02T20:51:05.017Z","Included","auto","No","165966","78181","1343655","30270","1618072","0.63"
"2025-09-02T20:40:19.733Z","Included","auto","No","18409","0","3287104","6073","3311586","0.86"
"2025-09-02T20:24:15.742Z","Included","auto","No","82290","0","2592240","17495","2692025","0.80"
"2025-09-02T20:11:31.676Z","Included","auto","No","50958","0","370040","34123","455121","0.28"
"2025-09-02T19:50:01.323Z","Included","auto","No","88757","0","2483043","9450","2581250","0.75"
"2025-09-02T19:27:37.274Z","Included","auto","No","175360","57946","1522887","11721","1767914","0.61"
"2025-09-02T19:11:05.525Z","Included","auto","No","6599","0","975006","2796","984401","0.26"
"2025-09-02T19:06:12.430Z","Included","auto","No","6845","0","706346","2784","715975","0.19"
"2025-09-02T19:01:17.813Z","Included","auto","No","4418","0","477790","1888","484096","0.13"
"2025-09-02T18:52:45.081Z","Included","auto","No","13969","0","1038564","4922","1057455","0.29"
"2025-09-02T18:45:50.236Z","Errored, Not Charged","auto","No","29055","0","317922","1829","348806","0.12"
"2025-09-02T15:34:33.979Z","Included","auto","No","567","0","96181","238","96986","0.03"
"2025-09-02T15:32:24.010Z","Included","auto","No","4541","0","185393","1780","191714","0.06"
"2025-09-02T15:24:26.500Z","Included","auto","No","86148","0","188583","2631","277362","0.14"
"2025-09-02T15:09:16.204Z","Included","auto","No","5978","0","170355","1626","177959","0.06"
"2025-09-02T15:06:06.606Z","Included","auto","No","9108","0","582231","2110","593449","0.16"
"2025-09-02T15:02:34.869Z","Errored, Not Charged","auto","No","87208","0","472299","3357","562864","0.22"
"2025-09-02T14:53:48.908Z","Included","auto","No","164954","49","861232","8156","1034391","0.69"
"2025-09-02T14:42:19.160Z","Included","auto","No","15347","0","230847","4953","251147","0.09"
"2025-09-02T14:36:21.482Z","Included","auto","No","91497","49","252924","5356","349826","0.38"
"2025-09-02T14:29:12.743Z","Included","auto","No","20319","0","515708","8828","544855","0.18"
"2025-09-02T14:24:07.210Z","Included","auto","No","22218","74239","66449","12667","175573","0.10"
"2025-09-02T14:16:08.016Z","Included","auto","No","9403","0","536692","3461","549556","0.16"
"2025-09-02T14:10:42.121Z","Errored, Not Charged","auto","No","0","0","0","0","0","0.00"
"2025-09-02T14:09:29.983Z","Included","auto","No","601","0","103071","463","104135","0.03"
"2025-09-02T14:02:57.472Z","Included","auto","No","95959","0","7113","303","103375","0.10"
"2025-09-02T13:12:26.583Z","Included","auto","No","1487","0","101069","232","102788","0.03"
"2025-09-02T13:10:17.091Z","Included","auto","No","6099","0","296516","1892","304507","0.09"
"2025-09-02T13:02:50.337Z","Included","auto","No","3251","0","190781","2168","196200","0.06"
"2025-09-02T13:00:58.396Z","Included","auto","No","2651","0","185381","1646","189678","0.06"
"2025-09-02T12:59:20.341Z","Included","auto","No","3233","0","268949","1860","274042","0.08"
"2025-09-02T12:51:20.911Z","Errored, Not Charged","auto","No","83920","0","476701","9555","570176","0.24"
"2025-09-02T12:44:27.067Z","Included","auto","No","9095","0","204000","2131","215226","0.07"
"2025-09-02T12:41:44.287Z","Included","auto","No","7451","0","845797","2303","855551","0.23"
"2025-09-02T12:40:17.139Z","Included","auto","No","5124","0","243148","1893","250165","0.07"
"2025-09-02T12:37:56.719Z","Included","auto","No","2763","0","234567","1778","239108","0.07"
"2025-09-02T12:35:36.164Z","Included","auto","No","7633","0","214113","2841","224587","0.07"
"2025-09-02T12:28:17.844Z","Included","auto","No","10527","0","143412","2017","155956","0.05"
"2025-09-02T12:16:04.769Z","Included","auto","No","22958","0","571697","4601","599256","0.18"
"2025-09-02T12:08:33.784Z","Included","auto","No","15255","0","735305","3797","754357","0.21"
"2025-09-02T12:06:06.047Z","Included","auto","No","2730","0","23262","327","26319","0.01"
"2025-09-02T12:02:21.560Z","Included","auto","No","33606","86002","39381","11230","170219","0.10"
"2025-09-02T11:57:02.481Z","Included","auto","No","5196","0","542095","3519","550810","0.15"
"2025-09-02T11:55:12.314Z","Included","auto","No","15064","0","184692","1087","200843","0.07"
"2025-09-02T11:52:04.057Z","Included","auto","No","85631","0","188473","1772","275876","0.14"
"2025-09-02T11:49:40.639Z","Included","auto","No","3963","0","346329","1902","352194","0.10"
"2025-09-02T11:44:40.761Z","Included","auto","No","4342","0","496969","2605","503916","0.14"
"2025-09-02T11:39:01.323Z","Included","auto","No","8826","0","917228","3240","929294","0.25"
"2025-09-02T11:37:32.421Z","Included","auto","No","65136","0","7113","365","72614","0.07"
"2025-09-02T11:25:09.816Z","Included","auto","No","397","0","13233","275","13905","0.005"
"2025-09-02T11:23:35.837Z","Included","auto","No","266","0","12968","307","13541","0.005"
"2025-09-02T11:22:04.102Z","Included","auto","No","123","0","12846","98","13067","0.004"
"2025-09-02T11:21:33.455Z","Included","auto","No","5684","0","7163","75","12922","0.01"
"2025-09-02T11:17:49.407Z","Included","auto","No","610","0","71083","275","71968","0.02"
"2025-09-02T11:17:08.802Z","Included","auto","No","694","0","70390","254","71338","0.02"
"2025-09-02T11:13:06.225Z","Included","auto","No","2929","0","411727","1798","416454","0.11"
"2025-09-02T11:10:59.561Z","Included","auto","No","536","0","66932","388","67856","0.02"
"2025-09-02T11:09:26.134Z","Included","auto","No","963","0","65970","404","67337","0.02"
"2025-09-02T10:57:52.657Z","Errored, Not Charged","auto","No","1737","0","324806","546","327089","0.09"
"2025-09-02T10:50:57.723Z","Included","auto","No","57001","0","617048","3937","677986","0.23"
"2025-09-02T10:34:54.448Z","Included","auto","No","49408","0","528212","4390","582010","0.20"
"2025-09-02T09:51:09.359Z","Included","auto","No","19345","0","511594","3992","534931","0.16"
"2025-09-02T09:41:29.454Z","Included","auto","No","31817","91041","512293","18104","653255","0.24"
"2025-09-02T08:23:44.959Z","Errored, Not Charged","auto","No","6861","0","747197","3153","757211","0.21"
"2025-09-02T08:17:40.579Z","Included","auto","No","4460","0","502163","2177","508800","0.14"
"2025-09-02T08:12:30.340Z","Included","auto","No","7282","0","1050466","2387","1060135","0.28"
"2025-09-02T08:04:52.461Z","Included","auto","No","84314","0","977271","2558","1064143","0.34"
"2025-09-02T07:58:07.933Z","Included","auto","No","677","0","84362","157","85196","0.02"
"2025-09-02T07:57:11.633Z","Included","auto","No","77250","0","7113","575","84938","0.08"
"2025-09-02T07:45:28.952Z","Included","auto","No","76500","0","1015517","4820","1096837","0.35"
"2025-09-02T07:02:29.238Z","Included","auto","No","64714","0","694681","2545","761940","0.25"
"2025-09-02T06:51:22.852Z","Included","auto","No","4697","0","625357","2338","632392","0.17"
"2025-09-02T06:48:40.798Z","Errored, Not Charged","auto","No","1511","0","177693","474","179678","0.05"
"2025-09-02T06:35:53.811Z","Included","auto","No","51548","0","942182","3458","997188","0.30"
"2025-09-02T06:21:53.362Z","Included","auto","No","8121","0","734876","3218","746215","0.20"
"2025-09-02T06:12:40.220Z","Included","auto","No","14272","0","748040","1733","764045","0.21"
"2025-09-02T06:01:19.144Z","Included","auto","No","38957","90421","1742513","15071","1886962","0.54"
"2025-09-02T05:53:16.560Z","Included","auto","No","101139","14551","7113","8945","131748","0.14"
"2025-09-02T04:36:05.692Z","Included","auto","No","244908","59585","7393297","35617","7733407","2.24"
"2025-09-02T04:27:12.925Z","Included","auto","No","81738","0","1646488","6007","1734233","0.52"
"2025-09-02T03:58:11.716Z","Included","auto","No","60394","0","333495","2350","396239","0.15"
"2025-09-01T15:21:01.047Z","Included","auto","No","3061","0","369910","1478","374449","0.10"
"2025-09-01T15:16:03.031Z","Included","auto","No","5261","0","783669","2170","791100","0.21"
"2025-09-01T15:10:47.647Z","Included","auto","No","22721","0","244275","2365","269361","0.09"
"2025-09-01T15:05:26.840Z","Included","auto","No","26005","109370","420109","12014","567498","0.19"
"2025-09-01T14:56:33.932Z","Included","auto","No","110018","0","1344474","2443","1456935","0.46"
"2025-09-01T14:56:06.497Z","Aborted, Not Charged","auto","No","0","0","0","0","0","0.00"
"2025-09-01T14:46:34.349Z","Included","auto","No","8259","0","1474854","4320","1487433","0.39"
"2025-09-01T14:39:46.496Z","Included","auto","No","6450","0","1078803","3898","1089151","0.29"
"2025-09-01T14:33:11.633Z","Included","auto","No","9243","0","1082782","4216","1096241","0.30"
"2025-09-01T14:22:58.264Z","Included","auto","No","13128","0","849303","5615","868046","0.25"
"2025-09-01T14:11:19.705Z","Included","auto","No","10988","0","589141","5251","605380","0.18"
"2025-09-01T14:07:27.318Z","Included","auto","No","57753","52899","65296","4809","180757","0.10"
"2025-09-01T13:55:59.883Z","Included","auto","No","106636","0","407276","3937","517849","0.22"
"2025-09-01T09:50:21.096Z","Included","auto","No","7477","0","391886","3102","402465","0.12"
"2025-09-01T09:47:34.502Z","Included","auto","No","50551","0","648845","3416","702812","0.23"
"2025-09-01T09:25:03.336Z","Included","auto","No","42191","0","188497","5525","236213","0.11"
"2025-09-01T05:22:58.442Z","Errored, Not Charged","auto","No","20884","0","172431","10327","203642","0.11"
"2025-08-31T21:49:32.122Z","Included","auto","No","9045","2381","531940","2838","546204","0.24"
"2025-08-31T21:44:42.137Z","Included","auto","No","13467","386","905005","6682","925540","0.42"
"2025-08-31T21:39:53.766Z","Included","auto","No","5862","667","717835","3302","727666","0.29"
"2025-08-31T21:35:18.522Z","Included","auto","No","69801","78888","566612","11501","726802","0.55"
"2025-08-31T21:26:49.783Z","Included","auto","No","20192","764","1246748","8415","1276119","0.58"
"2025-08-31T21:22:43.064Z","Included","auto","No","139649","786","597870","4638","742943","0.77"
"2025-08-31T21:15:52.542Z","Included","auto","No","6514","653","822740","2419","832326","0.31"
"2025-08-31T21:12:35.689Z","Included","auto","No","9826","734","512077","5051","527688","0.27"
"2025-08-31T21:06:12.873Z","Included","auto","No","10409","721","1065901","3998","1081029","0.42"
"2025-08-31T21:01:28.140Z","Included","auto","No","103192","675","123766","998","228631","0.44"
"2025-08-31T20:50:27.748Z","Included","auto","No","20136","151","1830631","9220","1860138","0.76"
"2025-08-31T20:48:10.618Z","Included","auto","No","5426","177","710677","1858","718138","0.26"
"2025-08-31T20:46:22.347Z","Included","auto","No","2846","734","168037","968","172585","0.08"
"2025-08-31T20:41:39.877Z","Included","auto","No","72653","685","413770","1601","488709","0.42"
"2025-08-31T20:33:47.442Z","Included","auto","No","66194","841","426676","7886","501597","0.50"
"2025-08-31T20:22:31.148Z","Included","auto","No","51288","79683","864569","18646","1014186","0.70"
"2025-08-31T20:10:54.188Z","Included","auto","No","153840","756","940984","9046","1104626","1.00"
"2025-08-31T20:01:37.738Z","Included","auto","No","14688","721","1092801","6335","1114545","0.48"
"2025-08-31T19:56:01.659Z","Included","auto","No","14335","163","1713019","7084","1734601","0.67"
"2025-08-31T19:50:00.960Z","Included","auto","No","17371","123","1259344","8473","1285311","0.57"
"2025-08-31T19:49:17.605Z","Included","auto","No","1360","205","96538","862","98965","0.05"
"2025-08-31T19:44:33.991Z","Included","auto","No","709","228","95829","1129","97895","0.05"
"2025-08-31T19:41:03.684Z","Included","auto","No","8601","164","451844","3786","464395","0.23"
"2025-08-31T19:38:34.344Z","Included","auto","No","76029","289","11199","997","88514","0.30"
"2025-08-31T19:25:16.956Z","Included","auto","No","2803","247","254300","1179","258529","0.11"
"2025-08-31T19:22:26.082Z","Included","auto","No","6637","180","640867","2952","650636","0.26"
"2025-08-31T19:18:06.075Z","Included","auto","No","7974","834","360469","3563","372840","0.19"
"2025-08-31T19:12:05.865Z","Included","auto","No","58147","791","657143","5237","721318","0.50"
"2025-08-31T19:04:18.320Z","Included","auto","No","47344","808","434807","4323","487282","0.38"
"2025-08-31T18:52:56.329Z","Included","auto","No","52953","139654","1156997","12159","1361763","0.72"
"2025-08-31T17:19:24.710Z","Included","auto","No","159893","0","3017135","4642","3181670","1.57"
"2025-08-31T17:18:17.439Z","Errored, Not Charged","auto","No","27721","129559","11199","4257","172736","0.15"
"2025-08-31T17:06:05.323Z","Included","auto","No","150320","1617","2010819","10616","2173372","1.33"
"2025-08-31T16:52:41.725Z","Included","auto","No","11383","598","1763736","5703","1781420","0.66"
"2025-08-31T16:47:43.587Z","Included","auto","No","11833","805","1240511","6142","1259291","0.51"
"2025-08-31T16:42:53.120Z","Included","auto","No","106823","5093","1264505","4400","1380821","0.86"
"2025-08-31T16:28:47.175Z","Included","auto","No","93707","1267","1721308","5781","1822063","0.96"
"2025-08-30T23:11:06.459Z","Included","auto","No","81713","24","1073077","5597","1160411","0.71"
"2025-08-30T23:08:26.427Z","Included","auto","No","572","20","14662","57","15311","0.01"
"2025-08-30T23:07:36.128Z","Included","auto","No","624","82","14038","492","15236","0.01"
"2025-08-30T23:05:51.523Z","Included","auto","No","7051","159","6987","467","14664","0.04"
"2025-08-30T22:55:28.503Z","Included","auto","No","112311","770","1076167","8223","1197471","0.87"
"2025-08-30T22:47:18.061Z","Included","auto","No","6579","233","1072731","4795","1084338","0.42"
"2025-08-30T22:45:49.375Z","Included","auto","No","623","164","104316","483","105586","0.04"
"2025-08-30T22:42:40.505Z","Included","auto","No","93117","690","800774","4724","899305","0.66"
"2025-08-30T22:25:31.688Z","Included","auto","No","69759","77099","880510","11184","1038552","0.65"
"2025-08-30T22:23:59.873Z","Included","auto","No","0","225","156314","600","157139","0.06"
"2025-08-30T22:22:52.935Z","Errored, Not Charged","auto","No","0","0","0","0","0","0.00"
"2025-08-30T22:19:33.693Z","Included","auto","No","144037","298","11199","777","156311","0.56"
"2025-08-30T22:00:50.764Z","Included","auto","No","143362","205","569349","2314","715230","0.74"
"2025-08-30T21:51:44.640Z","Included","auto","No","12676","708","906013","6316","925713","0.42"
"2025-08-30T21:44:23.181Z","Included","auto","No","72899","194","1021482","5884","1100459","0.67"
"2025-08-30T21:14:43.780Z","Included","auto","No","60354","275","540946","9090","610665","0.53"
"2025-08-30T21:06:23.273Z","Included","auto","No","8803","853","356279","5043","370978","0.22"
"2025-08-30T20:59:52.986Z","Included","auto","No","35205","2083","265412","5327","308027","0.30"
"2025-08-30T19:57:29.568Z","Included","auto","No","27158","82824","682478","8703","801163","0.41"
"2025-08-30T19:44:31.528Z","Included","auto","No","153600","733","1304730","3375","1462438","1.02"
"2025-08-30T19:37:37.379Z","Included","auto","No","9187","781","914561","5041","929570","0.39"
"2025-08-30T19:31:14.815Z","Included","auto","No","137638","844","1585024","5947","1729453","1.08"
"2025-08-30T19:23:57.283Z","Included","auto","No","14194","1756","1555287","6905","1578142","0.63"
"2025-08-30T19:18:01.061Z","Included","auto","No","111836","1537","1725075","9164","1847612","1.08"
"2025-08-30T18:54:43.144Z","Included","auto","No","94183","1008","5177575","18126","5290892","2.18"
"2025-08-30T17:33:53.196Z","Included","auto","No","57433","789","943436","13735","1015393","0.71"
"2025-08-30T16:53:39.714Z","Included","auto","No","35686","241","749519","14060","799506","0.56"
"2025-08-30T16:45:55.231Z","Included","auto","No","6817","702","449160","2941","459620","0.21"
"2025-08-30T16:39:46.290Z","Included","auto","No","16961","35","452046","4941","473983","0.27"
"2025-08-30T12:49:51.181Z","Included","auto","No","23953","1183","240381","5758","271275","0.25"
"2025-08-30T12:45:07.221Z","Included","auto","No","2941","655","56482","1085","61163","0.05"
"2025-08-30T12:39:28.606Z","Included","auto","No","6850","29","73808","2506","83193","0.09"
"2025-08-30T12:33:10.355Z","Included","auto","No","180","193","14561","358","15292","0.01"
"2025-08-30T12:31:57.261Z","Included","auto","No","777","57","27687","577","29098","0.02"
"2025-08-30T12:29:55.684Z","Included","auto","No","2585","8","24255","696","27544","0.03"
"2025-08-30T12:27:43.354Z","Included","auto","No","585","33","13259","163","14040","0.01"
"2025-08-30T12:27:06.036Z","Included","auto","No","516","65","12743","522","13846","0.01"
"2025-08-30T12:26:00.844Z","Included","auto","No","702","76","12041","442","13261","0.01"
"2025-08-30T12:24:18.979Z","Included","auto","No","524","216","11517","488","12745","0.01"
"2025-08-30T12:19:28.445Z","Included","auto","No","1404","1336","20922","865","24527","0.03"
"2025-08-30T12:17:14.033Z","Included","auto","No","518","183","9595","515","10811","0.01"
"2025-08-30T12:15:46.337Z","Included","auto","No","756","2","8839","518","10115","0.01"
"2025-08-30T12:11:32.366Z","Included","auto","No","1852","3","6987","650","9492","0.02"
"2025-08-29T15:29:27.732Z","Errored, Not Charged","auto","No","1592","0","134989","462","137043","0.04"
"2025-08-29T15:24:07.973Z","Included","auto","No","2456","0","61693","847","64996","0.02"
"2025-08-29T15:12:16.364Z","Included","auto","No","1428","0","36684","601","38713","0.01"
"2025-08-29T15:09:55.661Z","Included","auto","No","425","0","17531","365","18321","0.01"
"2025-08-29T15:03:38.913Z","Included","auto","No","1163","0","33136","666","34965","0.01"
"2025-08-29T14:56:13.405Z","Included","auto","No","5226","0","57859","969","64054","0.02"
"2025-08-29T14:50:25.112Z","Included","auto","No","2163","0","8986","700","11849","0.01"
"2025-08-29T14:39:54.273Z","Included","auto","No","5917","0","15408","395","21720","0.01"
"2025-08-29T06:04:05.289Z","Errored, Not Charged","auto","No","8625","0","293629","2500","304754","0.09"
"2025-08-29T05:59:16.490Z","Included","auto","No","90545","0","181900","4363","276808","0.15"
"2025-08-28T19:01:31.077Z","Included","auto","No","2165","0","63623","860","66648","0.02"
"2025-08-28T19:00:14.187Z","Included","auto","No","904","0","21915","366","23185","0.01"
"2025-08-28T18:56:07.664Z","Included","auto","No","854","0","18879","345","20078","0.01"
"2025-08-28T18:44:19.793Z","Errored, Not Charged","auto","No","0","0","0","0","0","0.00"
"2025-08-28T14:45:32.178Z","Included","auto","No","0","5451","0","34","5485","0.01"
"2025-08-28T14:44:53.953Z","Included","auto","No","0","5394","0","20","5414","0.01"
"2025-08-27T13:22:34.315Z","Included","auto","No","1187","0","237103","578","238868","0.06"
"2025-08-27T13:20:06.938Z","Included","auto","No","3088","0","536327","812","540227","0.14"
"2025-08-27T13:13:40.504Z","Included","auto","No","6322","0","1371278","1791","1379391","0.36"
"2025-08-27T13:09:46.280Z","Included","auto","No","2770","0","473146","778","476694","0.12"
"2025-08-27T13:08:38.227Z","Included","auto","No","618","0","132024","148","132790","0.03"
"2025-08-27T13:04:33.651Z","Errored, Not Charged","auto","No","61735","0","134458","221","196414","0.10"
"2025-08-26T21:38:52.027Z","Errored, Not Charged","auto","No","61561","0","571989","882","634432","0.21"
"2025-08-26T21:33:23.173Z","Errored, Not Charged","auto","No","2836","0","662071","904","665811","0.17"
"2025-08-26T21:26:41.767Z","Errored, Not Charged","auto","No","6448","0","881668","1394","889510","0.23"
"2025-08-26T21:26:35.799Z","Included","auto","No","0","0","0","0","0","0.00"
"2025-08-26T21:07:36.498Z","Included","auto","No","48132","0","3299868","8170","3356170","0.91"
"2025-08-26T20:59:56.209Z","Errored, Not Charged","auto","No","103767","10","3174626","2964","3281367","1.19"
"2025-08-26T20:55:39.467Z","Included","auto","No","6373","0","703671","1596","711640","0.19"
"2025-08-26T20:52:31.488Z","Included","auto","No","368","0","54537","940","55845","0.02"
"2025-08-26T20:48:05.038Z","Errored, Not Charged","auto","No","12078","0","249193","3037","264308","0.09"
"2025-08-26T20:41:20.064Z","Included","auto","No","5729","0","934550","2249","942528","0.25"
"2025-08-26T20:37:54.221Z","Errored, Not Charged","auto","No","55756","0","265665","626","322047","0.12"
"2025-08-26T20:28:04.823Z","Errored, Not Charged","auto","No","11266","0","114894","648","126808","0.04"
"2025-08-26T20:14:54.690Z","Errored, Not Charged","auto","No","15092","0","2219707","1615","2236414","0.58"
"2025-08-26T20:08:32.255Z","Included","auto","No","3076","0","811315","976","815367","0.21"
"2025-08-26T20:03:30.859Z","Included","auto","No","4608","0","769066","1495","775169","0.20"
"2025-08-26T20:01:20.001Z","Included","auto","No","50540","0","364371","823","415734","0.14"
"2025-08-26T19:51:28.996Z","Errored, Not Charged","auto","No","27500","0","5071","404","32975","0.03"
"2025-08-26T19:40:01.329Z","Errored, Not Charged","auto","No","0","0","0","0","0","0.00"
"2025-08-26T18:34:48.281Z","Errored, Not Charged","auto","No","330","0","9804","665","10799","0.01"
"2025-08-26T18:32:05.027Z","Included","auto","No","1473","0","17003","837","19313","0.01"
"2025-08-26T18:28:46.829Z","Included","auto","No","1375","0","14315","817","16507","0.01"
"2025-08-26T18:26:15.089Z","Included","auto","No","1258","0","11781","756","13795","0.01"
"2025-08-26T18:24:01.156Z","Included","auto","No","2635","0","12379","843","15857","0.01"
"2025-08-25T23:01:09.623Z","Included","auto","No","2675","0","98402","640","101717","0.03"
"2025-08-25T22:59:19.153Z","Included","auto","No","1018","0","50369","504","51891","0.02"
"2025-08-25T22:39:37.242Z","Included","auto","No","8326","0","180642","1718","190686","0.06"
"2025-08-25T22:38:45.901Z","Included","auto","No","1117","0","17223","410","18750","0.01"
"2025-08-25T22:04:20.571Z","Errored, Not Charged","auto","No","971","0","242003","492","243466","0.06"
"2025-08-25T21:56:50.792Z","Errored, Not Charged","auto","No","1463","0","154981","799","157243","0.04"
"2025-08-25T21:55:26.622Z","Included","auto","No","2335","0","371277","880","374492","0.10"
"2025-08-25T21:52:31.196Z","Errored, Not Charged","auto","No","3086","0","480313","1192","484591","0.13"
"2025-08-25T21:51:06.648Z","Included","auto","No","1323","0","64059","491","65873","0.02"
"2025-08-25T21:47:56.319Z","Included","auto","No","2854","0","300733","779","304366","0.08"
"2025-08-25T21:45:01.344Z","Included","auto","No","1948","0","222712","598","225258","0.06"
"2025-08-25T21:39:08.711Z","Included","auto","No","22938","0","516529","1769","541236","0.16"
"2025-08-25T21:38:02.417Z","Included","auto","No","1157","0","20831","221","22209","0.01"
"2025-08-25T21:31:06.304Z","Included","auto","No","16650","0","414329","3173","434152","0.13"
"2025-08-25T21:15:18.733Z","Errored, Not Charged","auto","No","5853","0","1363372","1503","1370728","0.35"
"2025-08-25T21:09:49.063Z","Errored, Not Charged","auto","No","93486","0","752690","1232","847408","0.29"
"2025-08-25T21:07:48.090Z","Included","auto","No","10368","0","81784","596","92748","0.03"
"2025-08-25T21:00:48.272Z","Included","auto","No","2986","0","643797","11228","658011","0.21"
"2025-08-25T20:56:21.819Z","Included","auto","No","2249","0","699270","869","702388","0.18"
"2025-08-25T20:49:07.364Z","Errored, Not Charged","auto","No","51110","0","1569187","2942","1623239","0.46"
"2025-08-25T20:41:28.359Z","Included","auto","No","54423","96320","1038790","5289","1194822","0.35"
"2025-08-25T20:37:09.294Z","Included","auto","No","17812","0","1012388","1011","1031211","0.27"
"2025-08-25T20:33:41.786Z","Included","auto","No","16728","0","759674","892","777294","0.21"
"2025-08-25T20:29:16.433Z","Included","auto","No","17152","0","773159","934","791245","0.21"
"2025-08-25T20:25:57.454Z","Included","auto","No","2422","0","515020","515","517957","0.13"
"2025-08-25T20:12:02.767Z","Included","auto","No","59376","0","509143","1048","569567","0.19"
"2025-08-25T16:42:36.716Z","Included","auto","No","1687","0","179737","630","182054","0.05"
"2025-08-25T16:19:32.065Z","Included","auto","No","43264","0","976974","10345","1030583","0.33"
"2025-08-25T16:17:33.103Z","Included","auto","No","535","0","9424","507","10466","0.005"
"2025-08-25T16:15:36.935Z","Included","auto","No","7174","0","2251","481","9906","0.01"
"2025-08-25T15:33:58.112Z","Included","auto","No","296","0","23782","240","24318","0.01"
"2025-08-25T15:31:47.572Z","Included","auto","No","290","0","23493","273","24056","0.01"
"2025-08-25T15:29:57.624Z","Included","auto","No","444","0","23050","246","23740","0.01"
"2025-08-25T15:27:54.931Z","Included","auto","No","179","0","22872","187","23238","0.01"
"2025-08-25T15:23:06.016Z","Included","auto","No","19047","0","3826","150","23023","0.02"
"2025-08-25T15:18:30.238Z","Included","claude-3.7-sonnet-thinking","No","28512","78","10338","979","39907","0.12"
"2025-08-24T15:29:07.455Z","Included","claude-3.7-sonnet-thinking","No","2971","9819","25156","1896","39842","0.08"
"2025-08-24T15:24:02.386Z","Included","claude-3.7-sonnet-thinking","No","3995","3829","77050","2393","87267","0.08"
"2025-08-24T15:23:41.139Z","Included","claude-3.7-sonnet-thinking","No","353","201","24279","507","25340","0.02"
"2025-08-24T15:22:25.427Z","Included","claude-3.7-sonnet-thinking","No","440","144","23839","330","24753","0.01"
"2025-08-24T15:21:27.787Z","Included","claude-3.7-sonnet-thinking","No","431","123","23408","727","24689","0.02"
"2025-08-24T15:20:46.394Z","Included","claude-3.7-sonnet-thinking","No","391","106","23017","428","23942","0.02"
"2025-08-24T15:20:21.671Z","Included","claude-3.7-sonnet-thinking","No","353","176","22664","509","23702","0.02"
"2025-08-24T15:19:24.883Z","Included","claude-3.7-sonnet-thinking","No","215","129","22449","377","23170","0.01"
"2025-08-24T15:18:49.913Z","Included","claude-3.7-sonnet-thinking","No","565","123","21884","218","22790","0.01"
"2025-08-24T15:17:49.059Z","Included","claude-3.7-sonnet-thinking","No","167","178","21717","663","22725","0.02"
"2025-08-24T15:16:52.767Z","Included","claude-3.7-sonnet-thinking","No","329","129","21388","112","21958","0.01"
"2025-08-24T15:16:22.818Z","Included","claude-3.7-sonnet-thinking","No","341","140","21047","395","21923","0.01"
"2025-08-24T15:15:38.469Z","Included","claude-3.7-sonnet-thinking","No","490","114","20557","364","21525","0.01"
"2025-08-24T15:13:58.928Z","Included","claude-3.7-sonnet-thinking","No","533","133","20024","562","21252","0.02"
"2025-08-24T15:12:03.259Z","Included","claude-3.7-sonnet-thinking","No","394","197","19630","587","20808","0.02"
"2025-08-24T15:10:35.090Z","Included","claude-3.7-sonnet-thinking","No","655","147","18975","534","20311","0.02"
"2025-08-24T15:07:50.258Z","Included","claude-3.7-sonnet-thinking","No","352","250","18623","823","20048","0.02"
"2025-08-24T15:05:55.442Z","Included","claude-3.7-sonnet-thinking","No","177","160","18446","356","19139","0.01"
"2025-08-24T15:05:18.148Z","Included","claude-3.7-sonnet-thinking","No","399","135","18047","96","18677","0.01"
"2025-08-24T15:04:38.105Z","Included","claude-3.7-sonnet-thinking","No","1755","169","16292","631","18847","0.02"
"2025-08-24T15:02:41.983Z","Included","claude-3.7-sonnet-thinking","No","4605","663","29920","1224","36412","0.05"
"2025-08-24T15:00:14.697Z","Included","claude-3.7-sonnet-thinking","No","4567","473","70732","1151","76923","0.06"
"2025-08-24T14:56:04.474Z","Included","claude-3.7-sonnet-thinking","No","2985","103","61625","1317","66030","0.05"
"2025-08-24T14:54:54.492Z","Included","claude-3.7-sonnet-thinking","No","1738","89","21185","774","23786","0.02"
"2025-08-24T13:23:22.081Z","Included","auto","No","2712","0","612112","1043","615867","0.16"
"2025-08-24T13:16:17.501Z","Included","auto","No","18165","0","48770","528","67463","0.03"
"2025-08-24T13:05:18.717Z","Included","auto","No","115816","0","3904062","6242","4026120","1.12"
"2025-08-24T12:34:45.598Z","Included","auto","No","2078","0","139443","1157","142678","0.04"
"2025-08-24T12:27:40.783Z","Included","auto","No","3465","0","265494","953","269912","0.07"
"2025-08-24T12:19:35.650Z","Included","auto","No","37112","0","5325","556","42993","0.04"
"2025-08-24T12:09:45.373Z","Included","auto","No","38932","0","169500","560","208992","0.08"
"2025-08-24T12:00:34.063Z","Included","auto","No","375","0","40252","296","40923","0.01"
"2025-08-24T11:55:17.848Z","Included","auto","No","13206","0","555018","10132","578356","0.19"
"2025-08-24T11:48:15.977Z","Included","auto","No","925","0","52752","483","54160","0.02"
"2025-08-24T11:42:25.443Z","Included","auto","No","10620","0","633405","3873","647898","0.18"
"2025-08-24T11:40:58.128Z","Included","auto","No","2178","0","27218","341","29737","0.01"
"2025-08-24T11:39:33.441Z","Included","auto","No","2587","0","33259","414","36260","0.01"
"2025-08-24T11:37:50.897Z","Included","auto","No","2896","0","47015","542","50453","0.02"
"2025-08-24T11:28:25.426Z","Included","auto","No","1076","0","6823","291","8190","0.004"
"2025-08-24T11:25:16.625Z","Included","auto","No","2672","0","4152","394","7218","0.01"
"2025-08-24T11:20:28.848Z","Included","auto","No","372","0","71618","294","72284","0.02"
"2025-08-24T11:08:56.648Z","Included","auto","No","67824","0","2083019","3389","2154232","0.60"
"2025-08-24T09:53:17.612Z","Errored, Not Charged","auto","No","0","0","0","0","0","0.00"
"2025-08-24T09:52:38.513Z","Included","auto","No","0","0","0","0","0","0.00"
"2025-08-24T09:45:35.081Z","Included","auto","No","2103","0","299877","402","302382","0.08"
"2025-08-24T09:39:55.123Z","Included","auto","No","55139","0","1029882","1755","1086776","0.32"
"2025-08-24T08:59:22.593Z","Errored, Not Charged","auto","No","7474","0","891550","1684","900708","0.24"
"2025-08-24T08:58:07.265Z","Errored, Not Charged","auto","No","228","0","40608","0","40836","0.01"
"2025-08-24T08:49:50.859Z","Errored, Not Charged","auto","No","3954","0","269293","610","273857","0.07"
"2025-08-24T08:40:33.117Z","Included","auto","No","6261","0","666571","1674","674506","0.18"
"2025-08-24T08:32:14.226Z","Included","auto","No","26427","0","552301","1932","580660","0.17"
"2025-08-24T06:00:13.469Z","Errored, Not Charged","auto","No","3425","0","244970","821","249216","0.07"
"2025-08-24T05:58:12.018Z","Included","auto","No","5553","0","73911","738","80202","0.03"
"2025-08-24T05:55:36.933Z","Included","auto","No","4078","0","164805","1239","170122","0.05"
"2025-08-24T05:46:10.837Z","Included","auto","No","5389","0","148311","1709","155409","0.05"
"2025-08-24T05:40:42.449Z","Included","auto","No","27389","0","406658","9421","443468","0.17"
"2025-08-24T05:34:36.451Z","Included","auto","No","7393","0","59955","8773","76121","0.06"
"2025-08-24T05:29:54.480Z","Included","auto","No","5327","0","177726","5755","188808","0.07"
"2025-08-24T05:27:06.103Z","Included","auto","No","17218","0","24140","4470","45828","0.04"
"2025-08-23T14:36:47.230Z","Included","auto","No","9862","0","1274168","2245","1286275","0.34"
"2025-08-23T14:14:45.367Z","Included","auto","No","29500","0","3005432","7555","3042487","0.81"
"2025-08-23T13:47:34.356Z","Included","auto","No","10922","0","266495","1860","279277","0.08"
"2025-08-23T07:29:58.748Z","Included","claude-3.7-sonnet-thinking","No","20667","83","279339","7056","307145","0.27"
"2025-08-23T07:23:46.134Z","Included","claude-3.7-sonnet-thinking","No","9962","5446","21666","9105","46179","0.17"
"2025-08-22T21:35:30.631Z","Included","auto","No","9659","0","2259","1439","13357","0.02"
"2025-08-22T21:18:02.111Z","Included","auto","No","5251","52","19352","5723","30378","0.11"
"2025-08-22T21:17:48.832Z","Included","auto","No","463","0","18848","219","19530","0.01"
"2025-08-22T21:17:21.050Z","Errored, Not Charged","auto","No","0","0","0","0","0","0.00"
"2025-08-22T21:06:54.049Z","Included","auto","No","2","0","9319","3899","13220","0.02"
"2025-08-22T21:06:53.920Z","Included","auto","No","2492","0","6829","3899","13220","0.02"
"2025-08-22T20:26:42.007Z","Included","auto","No","11466","0","15624","509","27599","0.02"
"2025-08-22T20:23:35.913Z","Included","auto","No","10457","0","2251","539","13247","0.01"
"2025-08-22T19:44:11.382Z","Included","auto","No","9530","0","128931","2966","141427","0.05"
"2025-08-22T19:29:42.556Z","Included","auto","No","1313","0","4165","1053","6531","0.01"
"2025-08-22T19:25:46.879Z","Included","auto","No","1911","0","2255","1128","5294","0.01"
"2025-08-22T19:18:12.276Z","Included","auto","No","1050","0","22870","436","24356","0.01"
"2025-08-22T19:15:02.609Z","Included","auto","No","679","0","10354","396","11429","0.005"
"2025-08-22T19:05:41.443Z","Included","auto","No","2359","0","53185","888","56432","0.02"
"2025-08-22T19:02:36.062Z","Included","auto","No","3153","0","86575","1041","90769","0.03"
"2025-08-22T18:57:24.836Z","Included","auto","No","854","0","12683","643","14180","0.01"
"2025-08-22T18:56:13.098Z","Included","auto","No","2667","0","19042","255","21964","0.01"
"2025-08-22T18:52:43.200Z","Included","auto","No","3383","0","102786","783","106952","0.03"
"2025-08-22T18:38:52.600Z","Included","auto","No","6065","0","273371","3277","282713","0.09"
"2025-08-22T18:38:17.700Z","Included","auto","No","8487","0","3840","94","12421","0.01"
"2025-08-22T18:36:35.191Z","Included","auto","No","447","0","7924","2150","10521","0.01"
"2025-08-22T18:35:29.209Z","Included","auto","No","530","0","7395","349","8274","0.004"
"2025-08-22T18:33:30.816Z","Included","auto","No","536","0","6860","427","7823","0.004"
"2025-08-22T18:31:22.456Z","Included","auto","No","796","0","6065","403","7264","0.004"
"2025-08-22T18:26:59.687Z","Included","auto","No","1937","0","4129","617","6683","0.01"
"2025-08-22T18:20:46.545Z","Included","auto","No","1875","0","2255","1770","5900","0.01"
"2025-08-22T17:37:34.120Z","Included","auto","No","18984","0","2251","1179","22414","0.02"
"2025-08-22T17:26:33.527Z","Included","auto","No","5248","0","351258","1520","358026","0.10"
"2025-08-22T17:17:53.502Z","Included","auto","No","13219","0","85392","2937","101548","0.05"
"2025-08-22T17:12:51.356Z","Included","auto","No","818","0","7348","1316","9482","0.01"
"2025-08-22T17:11:06.173Z","Included","auto","No","540","0","6809","512","7861","0.004"
"2025-08-22T17:08:47.826Z","Included","auto","No","1627","0","48728","825","51180","0.02"
"2025-08-22T17:06:56.505Z","Included","auto","No","2947","0","33007","866","36820","0.01"
"2025-08-22T16:56:12.679Z","Included","auto","No","345","0","4228","374","4947","0.003"
"2025-08-22T16:55:32.429Z","Included","auto","No","404","0","7905","239","8548","0.003"
"2025-08-22T15:03:21.515Z","Included","gpt-5","No","0","3086","47104","3858","54048","0.05"
"2025-08-21T19:34:45.236Z","Included","gpt-5","No","0","3214","27008","1926","32148","0.03"
"2025-08-21T19:33:22.254Z","Included","gpt-5","No","0","131","17664","666","18461","0.01"
"2025-08-21T19:32:50.729Z","Included","gpt-5","No","0","154","17408","390","17952","0.01"
"2025-08-21T19:32:11.470Z","Included","gpt-5","No","0","19","8704","1103","9826","0.01"
"2025-08-21T19:29:36.813Z","Included","gpt-5","No","0","5414","11520","1704","18638","0.03"
"2025-08-21T19:16:41.595Z","Included","auto","No","749","0","3838","334","4921","0.003"
"2025-08-21T19:15:00.532Z","Included","auto","No","32","0","2658","242","2932","0.002"
"2025-08-21T19:05:07.815Z","Included","auto","No","533","0","2775","339","3647","0.003"
"2025-08-21T18:56:49.445Z","Included","auto","No","522","0","2254","482","3258","0.003"
"2025-08-20T15:13:42.173Z","Included","auto","No","193","0","32845","217","33255","0.01"
"2025-08-20T15:11:50.351Z","Included","auto","No","4919","0","58391","1978","65288","0.03"
"2025-08-20T15:09:45.785Z","Included","auto","No","2367","0","25562","1887","29816","0.02"
"2025-08-20T15:08:11.125Z","Included","auto","No","3880","0","21683","242","25805","0.01"
"2025-08-20T15:06:10.408Z","Included","auto","No","17846","0","3838","1646","23330","0.03"
"2025-08-20T15:04:21.306Z","Included","auto","No","16844","0","3821","662","21327","0.02"
"2025-08-20T15:00:37.097Z","Included","auto","No","3265","0","13458","1530","18253","0.01"
"2025-08-20T14:58:22.391Z","Included","auto","No","701","0","12758","1592","15051","0.01"
"2025-08-20T14:56:56.824Z","Included","auto","No","222","0","12537","315","13074","0.005"
"2025-08-20T14:56:05.049Z","Included","auto","No","403","0","12135","202","12740","0.004"
"2025-08-20T14:53:23.419Z","Included","auto","No","342","0","11794","286","12422","0.004"
"2025-08-20T14:52:15.801Z","Included","auto","No","392","0","11403","240","12035","0.004"
"2025-08-20T14:46:40.528Z","Included","auto","No","384","0","11020","245","11649","0.004"
"2025-08-20T14:46:16.894Z","Included","auto","No","383","0","10638","279","11300","0.004"
"2025-08-20T14:44:46.766Z","Included","auto","No","404","0","10235","264","10903","0.004"
"2025-08-20T14:39:55.963Z","Included","auto","No","267","0","9969","176","10412","0.003"
"2025-08-20T14:30:37.585Z","Included","auto","No","216","0","9754","245","10215","0.004"
"2025-08-20T14:29:04.560Z","Included","auto","No","306","0","9449","168","9923","0.003"
"2025-08-20T14:19:11.411Z","Included","auto","No","282","0","9168","278","9728","0.004"
"2025-08-20T14:17:32.823Z","Included","auto","No","219","0","8950","228","9397","0.003"
"2025-08-20T14:12:32.456Z","Included","auto","No","485","0","8466","198","9149","0.003"
"2025-08-20T14:05:18.783Z","Included","auto","No","6213","0","2254","371","8838","0.01"
"2025-08-16T12:26:15.996Z","free","auto","No","14488","0","389030","8439","411957","0.15"
"2025-08-16T12:03:50.989Z","free","auto","No","15126","0","95627","4364","115117","0.06"
"2025-08-16T10:49:16.906Z","free","auto","No","5814","0","476731","1866","484411","0.13"
"2025-08-16T10:44:15.355Z","free","auto","No","3339","0","169279","1389","174007","0.05"
"2025-08-16T10:39:10.006Z","free","auto","No","37101","0","163646","1177","201924","0.08"
"2025-08-16T10:02:51.016Z","free","auto","No","876","0","70324","1267","72467","0.02"
"2025-08-16T09:56:21.124Z","free","auto","No","32606","0","37026","547","70179","0.04"
"2025-08-15T19:45:03.769Z","free","auto","No","473","0","18935","524","19932","0.01"
"2025-08-15T19:42:59.956Z","free","auto","No","16682","0","2254","445","19381","0.02"
"2025-08-15T19:41:15.346Z","free","auto","No","16142","0","18128","598","34868","0.02"
"2025-08-15T19:15:11.496Z","free","auto","No","3035","0","867114","1843","871992","0.23"
"2025-08-15T19:09:24.386Z","free","auto","No","3946","0","647465","1978","653389","0.17"
"2025-08-15T19:01:41.901Z","free","auto","No","86791","0","711605","3643","802039","0.28"
"2025-08-15T18:37:30.516Z","free","auto","No","10296","0","578550","1856","590702","0.16"
"2025-08-15T18:27:26.425Z","free","auto","No","15190","0","196322","7633","219145","0.09"
"2025-08-15T18:18:54.553Z","free","auto","No","56575","0","278725","5660","340960","0.15"
"2025-08-15T16:58:56.047Z","free","auto","No","2336","0","200629","1617","204582","0.06"
"2025-08-15T16:55:11.843Z","free","auto","No","3608","0","237361","1786","242755","0.07"
"2025-08-15T16:50:41.561Z","free","auto","No","9981","0","409982","1845","421808","0.12"
"2025-08-15T16:33:25.358Z","free","auto","No","31944","0","298280","5752","335976","0.13"
"2025-08-15T15:32:59.211Z","free","auto","No","19958","0","59402","6476","85836","0.06"
"2025-08-15T15:30:57.634Z","free","auto","No","5967","0","2254","878","9099","0.01"
"2025-08-12T15:38:33.621Z","free","auto","No","4922","0","3838","700","9460","0.01"
"2025-08-12T14:59:17.219Z","free","auto","No","644","0","8567","272","9483","0.004"
"2025-08-12T14:57:16.283Z","free","auto","No","218","0","7850","319","8387","0.003"
"2025-08-12T14:57:11.194Z","free","auto","No","374","0","3552","340","4266","0.003"
"2025-08-11T20:43:40.075Z","free","gpt-5","No","0","1058793","469632","3773","1532198","1.42"
"2025-08-11T20:26:08.785Z","free","gpt-5","No","0","1253799","437760","7404","1698963","1.70"
"2025-08-11T20:18:15.802Z","free","gpt-5","No","0","393912","35328","3996","433236","0.54"
"2025-08-11T19:51:06.164Z","free","gpt-5","No","0","180613","789632","2536","972781","0.35"
"2025-08-11T15:25:09.603Z","free","gpt-5","No","0","10417","822016","7360","839793","0.19"
"2025-08-11T15:21:04.137Z","free","gpt-5","No","0","3162","352000","4469","359631","0.09"
"2025-08-11T15:05:25.630Z","free","gpt-5","No","0","119860","1115008","16432","1251300","0.45"
"2025-08-11T15:00:28.598Z","free","gpt-5","No","0","1357","45312","1709","48378","0.02"
"2025-08-11T14:51:52.497Z","free","gpt-5","No","0","37388","62848","3687","103923","0.09"
